protocol_type,service,src_bytes,dst_bytes,duration,bytes_ratio,total_bytes,bytes_per_second,label
2,2,480,517,8,0.9266409266409267,997,110.77777777777777,0
0,1,695,780,94,0.8898847631241997,1475,15.526315789473685,0
2,1,3018,700,21,4.30527817403709,3718,169.0,0
2,3,1435,375,4,3.8164893617021276,1810,362.0,0
0,0,560,1724,4,0.32463768115942027,2284,456.8,0
0,3,55,881,28,0.06235827664399093,936,32.275862068965516,0
2,1,184,183,53,1.0,367,6.796296296296297,0
1,3,608,308,41,1.9676375404530744,916,21.80952380952381,0
2,3,1681,1240,31,1.3545527800161161,2921,91.28125,0
2,1,479,88,5,5.382022471910112,567,94.5,0
2,2,773,1109,3,0.6963963963963964,1882,470.5,0
2,1,2223,355,0,6.24438202247191,2578,2578.0,1
0,2,2451,641,3,3.817757009345794,3092,773.0,0
2,1,243,263,43,0.9204545454545454,506,11.5,0
1,1,44,3441,67,0.012783265543288786,3485,51.25,0
0,1,364,1890,8,0.19249074563722898,2254,250.44444444444446,0
1,0,1190,2109,47,0.5639810426540285,3299,68.72916666666667,0
1,2,3018,163,6,18.402439024390244,3181,454.42857142857144,1
1,0,80,1474,8,0.05423728813559322,1554,172.66666666666666,0
1,1,28,613,7,0.04560260586319218,641,80.125,0
0,3,2155,984,1,2.1878172588832485,3139,1569.5,0
0,0,1378,196,6,6.99492385786802,1574,224.85714285714286,0
1,2,4859,995,14,4.878514056224899,5854,390.26666666666665,1
1,1,505,1965,15,0.2568667344862665,2470,154.375,0
0,0,537,249,11,2.148,786,65.5,0
0,3,189,212,21,0.8873239436619719,401,18.227272727272727,0
0,0,123,88,14,1.3820224719101124,211,14.066666666666666,0
2,2,864,248,105,3.4698795180722892,1112,10.49056603773585,1
2,0,453,613,49,0.737785016286645,1066,21.32,0
2,3,83,1430,80,0.058001397624039136,1513,18.679012345679013,0
1,3,2180,261,24,8.320610687022901,2441,97.64,1
2,2,221,776,34,0.28442728442728443,997,28.485714285714284,0
1,3,1380,522,5,2.638623326959847,1902,317.0,0
1,1,331,272,41,1.2124542124542124,603,14.357142857142858,0
2,3,1676,571,8,2.93006993006993,2247,249.66666666666666,0
1,1,126,147,4,0.8513513513513513,273,54.6,0
2,0,1410,816,1,1.7258261933904528,2226,1113.0,0
2,1,103,98,19,1.0404040404040404,201,10.05,0
0,1,592,1050,10,0.5632730732635585,1642,149.27272727272728,0
2,0,1324,156,129,8.433121019108281,1480,11.384615384615385,0
0,3,190,5038,8,0.03770589402659258,5228,580.8888888888889,1
2,1,336,1388,60,0.24190064794816415,1724,28.262295081967213,0
2,3,2000,337,11,5.9171597633136095,2337,194.75,1
0,0,2163,444,41,4.860674157303371,2607,62.07142857142857,0
0,2,45,240,32,0.18672199170124482,285,8.636363636363637,0
2,3,184,1165,24,0.15780445969125215,1349,53.96,0
1,3,124,383,16,0.3229166666666667,507,29.823529411764707,0
0,2,198,1125,33,0.17584369449378331,1323,38.911764705882355,0
1,2,3512,14,15,234.13333333333333,3526,220.375,0
1,0,802,116,23,6.854700854700854,918,38.25,0
1,3,631,363,26,1.7335164835164836,994,36.81481481481482,0
0,3,4164,92,9,44.774193548387096,4256,425.6,1
1,0,814,735,12,1.1059782608695652,1549,119.15384615384616,0
0,3,1082,41,0,25.761904761904763,1123,1123.0,0
1,1,404,1571,57,0.25699745547073793,1975,34.05172413793103,0
2,1,481,1146,42,0.41935483870967744,1627,37.83720930232558,0
2,1,902,194,6,4.625641025641026,1096,156.57142857142858,0
0,3,72,528,13,0.13610586011342155,600,42.857142857142854,0
2,1,295,480,16,0.6133056133056133,775,45.588235294117645,0
2,1,219,1032,12,0.21200387221684414,1251,96.23076923076923,0
1,0,16,410,48,0.038929440389294405,426,8.693877551020408,0
0,0,769,26,38,28.48148148148148,795,20.384615384615383,1
1,2,823,255,43,3.21484375,1078,24.5,0
1,2,484,502,70,0.9622266401590457,986,13.887323943661972,0
1,2,312,2935,27,0.10626702997275204,3247,115.96428571428571,0
1,2,1055,1703,28,0.619131455399061,2758,95.10344827586206,0
1,0,144,160,38,0.8944099378881988,304,7.794871794871795,0
1,0,731,1027,34,0.7110894941634242,1758,50.22857142857143,0
1,0,1461,2209,61,0.6610859728506787,3670,59.193548387096776,0
0,1,179,7,44,22.375,186,4.133333333333334,0
2,1,1399,1021,3,1.3688845401174168,2420,605.0,0
1,2,1430,491,79,2.9065040650406506,1921,24.0125,0
1,1,61,912,34,0.06681270536692223,973,27.8,0
1,3,18,744,4,0.024161073825503355,762,152.4,0
1,0,3647,3342,44,1.090936284774155,6989,155.3111111111111,1
1,2,214,272,13,0.7838827838827839,486,34.714285714285715,0
1,2,1726,1233,49,1.3987034035656403,2959,59.18,0
2,3,825,213,93,3.8551401869158877,1038,11.042553191489361,0
2,1,307,457,8,0.6703056768558951,764,84.88888888888889,0
1,2,139,2963,58,0.04689608636977058,3102,52.57627118644068,0
2,1,686,1162,44,0.5898538263112639,1848,41.06666666666667,0
0,1,523,303,33,1.7203947368421053,826,24.294117647058822,0
1,3,1200,772,14,1.5523932729624839,1972,131.46666666666667,0
0,2,2345,40,3,57.19512195121951,2385,596.25,1
0,1,1636,247,19,6.596774193548387,1883,94.15,0
1,1,320,1013,3,0.3155818540433925,1333,333.25,0
2,3,2111,675,20,3.1227810650887573,2786,132.66666666666666,0
0,3,1792,507,51,3.52755905511811,2299,44.21153846153846,0
1,1,2646,939,181,2.8148936170212764,3585,19.697802197802197,0
0,3,613,406,6,1.5061425061425062,1019,145.57142857142858,0
0,1,1463,21,6,66.5,1484,212.0,1
0,2,895,465,49,1.9206008583690988,1360,27.2,0
0,0,371,1859,18,0.19946236559139785,2230,117.36842105263158,0
2,3,5190,1553,74,3.33976833976834,6743,89.90666666666667,1
0,0,39,420,43,0.09263657957244656,459,10.431818181818182,0
0,1,177,17,40,9.833333333333334,194,4.7317073170731705,1
0,1,2230,809,3,2.753086419753086,3039,759.75,0
2,1,62,1081,1,0.05730129390018484,1143,571.5,0
0,0,2178,278,11,7.806451612903226,2456,204.66666666666666,1
0,1,1256,518,7,2.420038535645472,1774,221.75,0
2,3,37,3848,37,0.009612886464016628,3885,102.23684210526316,0
2,2,560,687,17,0.813953488372093,1247,69.27777777777777,0
2,2,1404,345,22,4.057803468208093,1749,76.04347826086956,0
0,3,874,789,50,1.1063291139240505,1663,32.6078431372549,0
2,2,2746,158,19,17.270440251572328,2904,145.2,0
2,0,2022,177,23,11.359550561797754,2199,91.625,0
0,1,404,2071,55,0.19498069498069498,2475,44.19642857142857,0
2,1,88,218,16,0.4018264840182648,306,18.0,0
0,1,2887,297,2,9.687919463087248,3184,1061.3333333333333,1
1,0,728,627,22,1.1592356687898089,1355,58.91304347826087,0
2,0,77,1839,25,0.04184782608695652,1916,73.6923076923077,0
1,0,1695,1216,21,1.3927691043549713,2911,132.3181818181818,0
0,3,2028,35,8,56.333333333333336,2063,229.22222222222223,0
2,0,1020,944,7,1.0793650793650793,1964,245.5,0
0,2,593,561,13,1.0551601423487544,1154,82.42857142857143,0
1,3,1085,516,5,2.0986460348162477,1601,266.8333333333333,0
0,3,1226,940,32,1.3028692879914985,2166,65.63636363636364,0
2,3,2235,174,28,12.771428571428572,2409,83.06896551724138,1
2,0,3120,3191,30,0.9774436090225563,6311,203.58064516129033,0
1,3,722,829,7,0.8698795180722891,1551,193.875,0
0,0,1601,364,8,4.3863013698630136,1965,218.33333333333334,1
2,0,3338,733,46,4.547683923705722,4071,86.61702127659575,1
1,3,163,195,35,0.8316326530612245,358,9.944444444444445,0
2,1,18,803,62,0.022388059701492536,821,13.031746031746032,0
2,1,2032,22,15,88.34782608695652,2054,128.375,0
0,3,217,333,23,0.6497005988023952,550,22.916666666666668,0
2,1,43,1101,40,0.03901996370235935,1144,27.902439024390244,0
0,2,174,1320,109,0.13171839515518546,1494,13.581818181818182,0
2,2,484,233,137,2.0683760683760686,717,5.195652173913044,0
1,0,247,620,213,0.3977455716586151,867,4.0514018691588785,0
2,1,364,601,66,0.6046511627906976,965,14.402985074626866,0
0,2,3700,437,30,8.447488584474886,4137,133.4516129032258,0
0,3,1218,207,0,5.855769230769231,1425,1425.0,0
1,1,1245,971,36,1.2808641975308641,2216,59.891891891891895,0
2,2,99,232,8,0.4248927038626609,331,36.77777777777778,0
2,2,1317,1935,1,0.6802685950413223,3252,1626.0,0
1,3,1344,601,35,2.2325581395348837,1945,54.02777777777778,0
2,0,1078,1635,42,0.6589242053789731,2713,63.093023255813954,0
2,3,259,274,32,0.9418181818181818,533,16.151515151515152,0
0,0,549,1316,13,0.4168564920273349,1865,133.21428571428572,0
2,2,1872,96,21,19.298969072164947,1968,89.45454545454545,0
2,0,1109,1164,81,0.951931330472103,2273,27.71951219512195,0
1,2,1319,391,39,3.364795918367347,1710,42.75,0
1,2,885,507,21,1.7421259842519685,1392,63.27272727272727,0
0,1,597,145,27,4.089041095890411,742,26.5,0
2,0,1423,15,78,88.9375,1438,18.20253164556962,1
2,0,70,877,15,0.07972665148063782,947,59.1875,0
2,0,1118,708,3,1.5768688293370945,1826,456.5,0
0,3,5879,779,11,7.537179487179487,6658,554.8333333333334,1
0,1,1515,235,16,6.419491525423729,1750,102.94117647058823,0
1,1,343,218,9,1.5662100456621004,561,56.1,0
0,1,325,1418,22,0.22903453136011276,1743,75.78260869565217,0
2,3,1100,1145,10,0.9598603839441536,2245,204.0909090909091,0
2,0,2261,328,3,6.872340425531915,2589,647.25,0
0,0,862,812,6,1.0602706027060271,1674,239.14285714285714,0
2,0,749,1408,75,0.531582682753726,2157,28.38157894736842,0
2,1,174,1757,29,0.09897610921501707,1931,64.36666666666666,0
0,1,1256,4,11,251.2,1260,105.0,0
0,2,1211,1343,13,0.9010416666666666,2554,182.42857142857142,0
2,3,3409,345,20,9.852601156069364,3754,178.76190476190476,0
2,3,356,1013,33,0.3510848126232742,1369,40.26470588235294,0
2,1,1412,371,26,3.795698924731183,1783,66.03703703703704,0
1,2,569,745,80,0.7627345844504021,1314,16.22222222222222,0
1,0,817,832,29,0.9807923169267707,1649,54.96666666666667,0
1,1,1695,415,72,4.074519230769231,2110,28.904109589041095,0
0,3,251,575,0,0.4357638888888889,826,826.0,0
1,3,419,1036,66,0.40405014464802314,1455,21.71641791044776,0
0,3,1484,517,38,2.864864864864865,2001,51.30769230769231,0
0,0,845,11,5,70.41666666666667,856,142.66666666666666,1
1,3,96,10,9,8.727272727272727,106,10.6,0
1,0,562,866,23,0.6482122260668973,1428,59.5,0
1,0,883,1503,4,0.5871010638297872,2386,477.2,0
2,0,2402,1230,46,1.9512591389114542,3632,77.27659574468085,0
1,1,208,297,46,0.697986577181208,505,10.74468085106383,0
2,0,1639,509,10,3.2137254901960786,2148,195.27272727272728,0
0,2,139,213,2,0.6495327102803738,352,117.33333333333333,0
2,3,277,3618,134,0.07654048079579995,3895,28.85185185185185,0
1,1,278,241,8,1.1487603305785123,519,57.666666666666664,0
0,3,2099,430,2,4.870069605568445,2529,843.0,0
0,0,221,914,12,0.24153005464480876,1135,87.3076923076923,0
0,1,1546,1670,104,0.9251944943147815,3216,30.62857142857143,0
2,2,619,42,47,14.395348837209303,661,13.770833333333334,0
1,0,7002,286,19,24.39721254355401,7288,364.4,1
0,3,1826,673,10,2.7091988130563798,2499,227.1818181818182,0
0,2,1345,770,16,1.7444876783398184,2115,124.41176470588235,0
0,0,2045,58,0,34.66101694915254,2103,2103.0,1
2,2,1005,872,38,1.1512027491408934,1877,48.12820512820513,0
2,0,1855,600,3,3.086522462562396,2455,613.75,0
1,1,302,1406,21,0.2146410803127221,1708,77.63636363636364,0
2,0,102,201,25,0.504950495049505,303,11.653846153846153,0
0,1,956,173,0,5.494252873563219,1129,1129.0,0
1,0,570,1261,117,0.45166402535657685,1831,15.516949152542374,0
0,0,555,973,10,0.5698151950718686,1528,138.9090909090909,0
0,3,748,1254,2,0.5960159362549801,2002,667.3333333333334,0
2,2,448,1218,57,0.3675143560295324,1666,28.724137931034484,0
1,2,983,87,4,11.170454545454545,1070,214.0,0
2,2,31,261,0,0.1183206106870229,292,292.0,0
2,0,3502,240,20,14.531120331950207,3742,178.1904761904762,0
1,0,2586,2181,4,1.1851512373968836,4767,953.4,1
0,0,2737,534,121,5.115887850467289,3271,26.811475409836067,1
0,1,454,94,0,4.778947368421052,548,548.0,0
1,1,759,273,1,2.77007299270073,1032,516.0,0
0,3,3081,1643,53,1.8740875912408759,4724,87.48148148148148,0
1,0,2326,1502,8,1.5475715236194278,3828,425.3333333333333,0
1,2,1561,1844,72,0.846070460704607,3405,46.64383561643836,0
2,2,523,393,11,1.3274111675126903,916,76.33333333333333,0
1,3,830,820,2,1.0109622411693058,1650,550.0,0
2,2,1574,260,0,6.030651340996169,1834,1834.0,1
0,3,318,159,9,1.9875,477,47.7,0
0,0,984,17,19,54.666666666666664,1001,50.05,1
0,2,1759,202,0,8.665024630541872,1961,1961.0,0
0,0,1229,741,26,1.65633423180593,1970,72.96296296296296,0
2,1,652,1876,12,0.34736281299946725,2528,194.46153846153845,0
0,2,878,114,14,7.6347826086956525,992,66.13333333333334,0
1,1,4480,2000,9,2.23888055972014,6480,648.0,0
1,2,921,338,22,2.7168141592920354,1259,54.73913043478261,0
1,0,1539,445,7,3.4506726457399104,1984,248.0,0
2,3,1296,363,4,3.5604395604395602,1659,331.8,0
0,0,1208,420,66,2.869358669833729,1628,24.29850746268657,0
0,0,1260,240,14,5.228215767634855,1500,100.0,0
0,0,605,959,2,0.6302083333333334,1564,521.3333333333334,0
2,2,642,1135,7,0.5651408450704225,1777,222.125,0
1,3,630,1385,11,0.45454545454545453,2015,167.91666666666666,0
1,1,33,333,44,0.09880239520958084,366,8.133333333333333,0
0,0,275,1157,0,0.2374784110535406,1432,1432.0,0
1,2,167,812,19,0.2054120541205412,979,48.95,0
1,1,2175,2534,15,0.8579881656804734,4709,294.3125,0
2,0,321,442,103,0.7246049661399548,763,7.336538461538462,0
2,1,149,3894,5,0.03825417201540436,4043,673.8333333333334,0
2,0,127,1078,29,0.11770157553290084,1205,40.166666666666664,0
2,1,1203,1197,6,1.0041736227045075,2400,342.85714285714283,0
0,1,6,20,23,0.2857142857142857,26,1.0833333333333333,0
2,3,637,550,24,1.1560798548094373,1187,47.48,0
1,3,126,601,2,0.20930232558139536,727,242.33333333333334,0
0,0,1894,33,18,55.705882352941174,1927,101.42105263157895,0
1,2,3180,299,18,10.6,3479,183.10526315789474,1
1,3,3188,2492,11,1.2787805856397914,5680,473.3333333333333,1
1,1,583,444,9,1.3101123595505617,1027,102.7,0
2,3,1034,165,7,6.228915662650603,1199,149.875,0
2,3,915,576,0,1.58578856152513,1491,1491.0,0
0,0,430,27,0,15.357142857142858,457,457.0,0
0,3,587,580,26,1.0103270223752152,1167,43.22222222222222,0
2,3,66,721,10,0.09141274238227147,787,71.54545454545455,0
1,1,1588,354,5,4.473239436619719,1942,323.6666666666667,0
0,3,275,1150,34,0.23892267593397046,1425,40.714285714285715,0
2,1,617,116,22,5.273504273504273,733,31.869565217391305,0
2,3,655,1684,73,0.3887240356083086,2339,31.60810810810811,0
2,3,822,2488,53,0.33025311370028126,3310,61.2962962962963,0
1,2,1703,0,38,1703.0,1703,43.666666666666664,0
2,3,1177,1479,4,0.7952702702702703,2656,531.2,0
2,1,1087,564,32,1.9238938053097345,1651,50.03030303030303,0
2,1,748,495,35,1.5080645161290323,1243,34.52777777777778,0
2,0,100,218,43,0.45662100456621,318,7.2272727272727275,0
0,0,514,474,9,1.0821052631578947,988,98.8,0
0,2,3153,2403,30,1.3115640599001663,5556,179.2258064516129,1
2,1,5414,189,28,28.49473684210526,5603,193.20689655172413,1
1,1,1311,157,14,8.29746835443038,1468,97.86666666666666,0
0,1,258,221,32,1.162162162162162,479,14.515151515151516,0
2,2,107,642,2,0.16640746500777606,749,249.66666666666666,0
0,1,535,2130,30,0.25105584232754574,2665,85.96774193548387,0
0,0,1941,682,27,2.841874084919473,2623,93.67857142857143,0
1,2,1279,223,7,5.709821428571429,1502,187.75,0
2,0,2153,464,51,4.63010752688172,2617,50.32692307692308,0
2,0,956,395,62,2.414141414141414,1351,21.444444444444443,0
1,2,139,38,7,3.5641025641025643,177,22.125,0
1,3,121,571,2,0.21153846153846154,692,230.66666666666666,0
2,3,49,107,27,0.4537037037037037,156,5.571428571428571,0
2,0,837,1477,19,0.5663058186738836,2314,115.7,0
1,3,278,636,16,0.4364207221350079,914,53.76470588235294,0
0,1,1325,1489,42,0.889261744966443,2814,65.44186046511628,0
0,2,1159,2499,104,0.4636,3658,34.838095238095235,0
1,0,382,2294,19,0.1664488017429194,2676,133.8,0
0,1,194,84,0,2.2823529411764705,278,278.0,0
1,3,108,2317,27,0.04659188955996549,2425,86.60714285714286,0
0,1,1336,1270,31,1.051140833988985,2606,81.4375,0
0,3,598,1202,52,0.4970906068162926,1800,33.9622641509434,0
2,0,390,75,6,5.131578947368421,465,66.42857142857143,0
2,1,1942,158,22,12.213836477987421,2100,91.30434782608695,0
0,2,900,2956,17,0.3043625295908015,3856,214.22222222222223,0
0,0,729,191,32,3.796875,920,27.87878787878788,0
2,1,1360,148,1,9.12751677852349,1508,754.0,0
2,1,1690,359,64,4.694444444444445,2049,31.523076923076925,0
2,3,1158,1956,21,0.5917220235053654,3114,141.54545454545453,0
1,0,579,517,62,1.1177606177606179,1096,17.396825396825395,0
0,0,476,2026,12,0.23482979773063642,2502,192.46153846153845,0
2,0,1476,325,31,4.52760736196319,1801,56.28125,0
0,0,729,205,94,3.5388349514563107,934,9.83157894736842,0
1,3,1218,546,86,2.226691042047532,1764,20.275862068965516,0
1,2,2210,764,86,2.888888888888889,2974,34.18390804597701,0
2,0,2475,397,1,6.21859296482412,2872,1436.0,0
1,3,325,339,15,0.9558823529411765,664,41.5,0
0,2,208,196,1,1.0558375634517767,404,202.0,0
2,2,302,257,11,1.1705426356589148,559,46.583333333333336,0
0,3,1391,894,5,1.5541899441340783,2285,380.8333333333333,0
0,0,462,369,29,1.2486486486486486,831,27.7,0
1,2,190,66,45,2.8358208955223883,256,5.565217391304348,0
1,0,103,118,21,0.865546218487395,221,10.045454545454545,0
1,0,396,372,47,1.061662198391421,768,16.0,0
1,1,146,2066,0,0.0706337687469763,2212,2212.0,0
1,0,170,381,51,0.44502617801047123,551,10.596153846153847,0
2,1,1151,50,5,22.568627450980394,1201,200.16666666666666,0
0,2,19,433,18,0.04377880184331797,452,23.789473684210527,0
0,3,125,884,17,0.14124293785310735,1009,56.05555555555556,0
0,1,1860,720,61,2.579750346740638,2580,41.61290322580645,0
0,3,1863,261,101,7.1106870229007635,2124,20.823529411764707,0
1,2,399,932,8,0.42765273311897106,1331,147.88888888888889,0
0,0,92,796,2,0.11543287327478043,888,296.0,0
2,2,1220,151,31,8.026315789473685,1371,42.84375,0
2,3,446,141,20,3.140845070422535,587,27.952380952380953,0
0,2,46,633,25,0.07255520504731862,679,26.115384615384617,0
0,0,171,861,1,0.19837587006960558,1032,516.0,0
2,2,147,2614,44,0.05621414913957935,2761,61.355555555555554,0
2,0,889,438,7,2.0250569476082005,1327,165.875,0
1,1,2283,1158,12,1.9698015530629853,3441,264.6923076923077,0
2,3,1575,99,7,15.75,1674,209.25,1
1,0,790,1762,87,0.44809982983550767,2552,29.0,0
1,0,548,802,5,0.6824408468244084,1350,225.0,0
1,2,964,793,39,1.2141057934508817,1757,43.925,0
1,1,586,122,8,4.764227642276423,708,78.66666666666667,1
1,0,282,32,16,8.545454545454545,314,18.470588235294116,0
0,1,1136,967,166,1.1735537190082646,2103,12.592814371257486,0
2,1,2065,99,3,20.65,2164,541.0,0
1,2,466,108,63,4.275229357798165,574,8.96875,0
2,0,1842,166,87,11.029940119760479,2008,22.818181818181817,0
2,2,564,82,35,6.795180722891566,646,17.944444444444443,0
1,3,513,785,0,0.6526717557251909,1298,1298.0,0
0,3,28,438,51,0.06378132118451026,466,8.961538461538462,0
1,0,1188,247,64,4.790322580645161,1435,22.076923076923077,1
0,1,1647,464,118,3.541935483870968,2111,17.73949579831933,0
2,0,1089,1487,54,0.7318548387096774,2576,46.836363636363636,0
0,0,164,2094,17,0.0782816229116945,2258,125.44444444444444,0
0,3,109,534,35,0.20373831775700935,643,17.86111111111111,0
0,3,850,669,19,1.2686567164179106,1519,75.95,0
2,1,513,237,13,2.1554621848739495,750,53.57142857142857,0
2,1,560,576,29,0.9705372616984402,1136,37.86666666666667,0
0,0,3435,1103,44,3.1114130434782608,4538,100.84444444444445,1
0,2,1287,542,30,2.3701657458563536,1829,59.0,0
1,0,530,287,52,1.8402777777777777,817,15.415094339622641,0
0,1,19,697,5,0.027220630372492838,716,119.33333333333333,0
1,2,34,2344,14,0.014498933901918977,2378,158.53333333333333,0
0,3,1154,1751,11,0.658675799086758,2905,242.08333333333334,0
1,1,1818,1173,6,1.5485519591141397,2991,427.2857142857143,0
2,1,1229,258,17,4.745173745173745,1487,82.61111111111111,1
0,2,520,221,88,2.3423423423423424,741,8.325842696629213,0
0,1,31,1458,23,0.021247429746401644,1489,62.041666666666664,0
0,1,3423,160,10,21.26086956521739,3583,325.72727272727275,1
0,1,4292,744,13,5.761073825503356,5036,359.7142857142857,1
1,1,797,462,28,1.7213822894168467,1259,43.41379310344828,0
0,1,73,504,13,0.14455445544554454,577,41.214285714285715,0
2,1,778,484,23,1.6041237113402063,1262,52.583333333333336,0
2,1,2228,1841,9,1.209554831704669,4069,406.9,0
0,1,1139,72,12,15.602739726027398,1211,93.15384615384616,0
2,3,1272,1221,36,1.0409165302782324,2493,67.37837837837837,0
0,1,88,1441,26,0.06102635228848821,1529,56.629629629629626,0
0,3,112,2290,2,0.048886948930597994,2402,800.6666666666666,0
2,3,136,482,108,0.2815734989648033,618,5.669724770642202,0
0,0,2347,554,1,4.228828828828829,2901,1450.5,0
2,0,746,2601,2,0.28670253651037664,3347,1115.6666666666667,0
1,3,1568,490,36,3.1934826883910388,2058,55.62162162162162,1
0,3,122,560,36,0.21746880570409982,682,18.43243243243243,0
1,1,2626,323,0,8.104938271604938,2949,2949.0,0
2,0,1721,25,30,66.1923076923077,1746,56.32258064516129,1
1,2,254,453,1,0.5594713656387665,707,353.5,0
1,0,2072,851,97,2.431924882629108,2923,29.8265306122449,0
2,3,305,936,35,0.3255069370330843,1241,34.47222222222222,0
1,3,229,5,6,38.166666666666664,234,33.42857142857143,1
1,1,306,1291,5,0.23684210526315788,1597,266.1666666666667,0
2,1,2407,542,25,4.432780847145488,2949,113.42307692307692,1
1,0,2472,588,30,4.196943972835314,3060,98.70967741935483,1
2,1,398,2610,53,0.152432018383761,3008,55.7037037037037,0
1,2,1222,267,70,4.559701492537314,1489,20.971830985915492,1
2,2,1126,1147,14,0.980836236933798,2273,151.53333333333333,0
2,1,1642,684,55,2.397080291970803,2326,41.535714285714285,0
1,2,351,965,23,0.36335403726708076,1316,54.833333333333336,0
1,2,713,432,19,1.6466512702078522,1145,57.25,0
1,0,1101,261,36,4.202290076335878,1362,36.810810810810814,0
0,2,26,631,3,0.04113924050632911,657,164.25,0
0,3,472,375,9,1.2553191489361701,847,84.7,0
0,3,1190,201,50,5.891089108910891,1391,27.274509803921568,1
2,0,291,1462,21,0.19890635680109364,1753,79.68181818181819,0
1,1,3163,516,71,6.117988394584139,3679,51.09722222222222,0
2,0,30,1503,2,0.0199468085106383,1533,511.0,0
0,1,3172,514,11,6.159223300970874,3686,307.1666666666667,0
1,1,244,650,13,0.37480798771121354,894,63.857142857142854,0
2,1,50,4284,16,0.011668611435239206,4334,254.94117647058823,0
1,1,345,2421,129,0.14244426094137078,2766,21.276923076923076,0
2,1,1543,253,11,6.074803149606299,1796,149.66666666666666,0
1,0,1396,1623,21,0.8596059113300493,3019,137.22727272727272,0
0,1,234,395,23,0.5909090909090909,629,26.208333333333332,0
0,2,219,59,44,3.65,278,6.177777777777778,0
1,2,1028,686,21,1.4963609898107715,1714,77.9090909090909,0
2,1,612,3019,27,0.20264900662251656,3631,129.67857142857142,0
0,2,1571,2929,41,0.5361774744027303,4500,107.14285714285714,0
0,3,24,108,3,0.22018348623853212,132,33.0,0
0,0,942,1180,99,0.7976291278577476,2122,21.22,0
1,0,1311,1298,56,1.0092378752886837,2609,45.771929824561404,0
1,1,5018,368,14,13.598915989159892,5386,359.06666666666666,0
2,1,1135,859,39,1.319767441860465,1994,49.85,0
2,3,263,535,43,0.4906716417910448,798,18.136363636363637,0
2,1,114,206,56,0.5507246376811594,320,5.614035087719298,0
1,2,1024,1145,6,0.893542757417103,2169,309.85714285714283,0
1,3,740,243,36,3.0327868852459017,983,26.56756756756757,0
2,2,2294,332,1,6.888888888888889,2626,1313.0,0
2,0,1296,168,3,7.668639053254438,1464,366.0,0
1,2,712,1016,44,0.7000983284169124,1728,38.4,0
2,0,516,491,50,1.048780487804878,1007,19.745098039215687,0
0,2,518,468,26,1.1044776119402986,986,36.51851851851852,0
1,0,256,742,26,0.3445491251682369,998,36.96296296296296,0
2,1,17,136,41,0.12408759124087591,153,3.642857142857143,0
1,2,855,1827,70,0.46772428884026257,2682,37.774647887323944,0
0,0,238,500,16,0.4750499001996008,738,43.411764705882355,0
1,2,233,365,3,0.6366120218579235,598,149.5,0
1,3,133,108,54,1.2201834862385321,241,4.381818181818182,0
1,1,210,147,12,1.4189189189189189,357,27.46153846153846,0
1,0,32,2024,4,0.01580246913580247,2056,411.2,0
0,3,1121,487,28,2.2971311475409837,1608,55.44827586206897,0
1,2,513,1024,25,0.5004878048780488,1537,59.11538461538461,0
1,3,824,67,19,12.117647058823529,891,44.55,1
2,2,1013,825,58,1.2263922518159807,1838,31.152542372881356,0
1,1,3593,2035,9,1.7647347740667976,5628,562.8,1
2,3,70,285,0,0.24475524475524477,355,355.0,0
0,1,541,692,11,0.7806637806637806,1233,102.75,0
0,0,282,2253,0,0.1251109139307897,2535,2535.0,0
0,2,647,1016,23,0.6361848574237955,1663,69.29166666666667,0
0,2,2531,51,14,48.67307692307692,2582,172.13333333333333,0
2,1,1287,380,50,3.377952755905512,1667,32.68627450980392,0
1,1,1084,71,47,15.055555555555555,1155,24.0625,0
0,0,582,1580,17,0.3681214421252372,2162,120.11111111111111,0
1,3,1112,777,7,1.429305912596401,1889,236.125,0
2,2,32,2505,16,0.012769353551476457,2537,149.23529411764707,0
2,2,882,15,30,55.125,897,28.93548387096774,0
2,0,806,440,6,1.8276643990929706,1246,178.0,0
0,0,425,88,44,4.775280898876405,513,11.4,0
1,1,225,345,12,0.6502890173410405,570,43.84615384615385,0
1,1,1647,141,80,11.598591549295774,1788,22.074074074074073,0
1,3,55,318,21,0.1724137931034483,373,16.954545454545453,0
2,0,72,1368,56,0.052593133674214754,1440,25.263157894736842,0
0,3,580,140,28,4.113475177304965,720,24.82758620689655,1
2,0,291,513,24,0.566147859922179,804,32.16,0
2,2,1368,2036,34,0.6715758468335787,3404,97.25714285714285,0
1,0,1005,5366,50,0.18725544997205143,6371,124.92156862745098,0
2,0,1480,230,31,6.406926406926407,1710,53.4375,0
1,2,392,2193,47,0.17866909753874202,2585,53.854166666666664,0
0,0,1349,242,6,5.551440329218107,1591,227.28571428571428,1
1,3,1982,426,9,4.6416861826697895,2408,240.8,1
0,1,423,1682,7,0.25133689839572193,2105,263.125,0
1,1,415,1234,48,0.3360323886639676,1649,33.6530612244898,0
2,3,2302,1558,2,1.4765875561257216,3860,1286.6666666666667,0
2,2,51,1288,47,0.0395655546935609,1339,27.895833333333332,0
0,0,431,214,14,2.0046511627906978,645,43.0,0
0,3,126,654,2,0.19236641221374046,780,260.0,0
0,1,29,389,16,0.07435897435897436,418,24.58823529411765,0
1,1,119,492,10,0.2413793103448276,611,55.54545454545455,0
1,3,564,133,26,4.208955223880597,697,25.814814814814813,0
0,1,1161,303,19,3.8190789473684212,1464,73.2,0
2,3,341,1559,10,0.2185897435897436,1900,172.72727272727272,0
1,1,1894,1822,59,1.03894679100384,3716,61.93333333333333,0
1,3,575,753,15,0.7625994694960212,1328,83.0,0
1,0,3449,551,19,6.2481884057971016,4000,200.0,0
0,0,3082,998,56,3.085085085085085,4080,71.57894736842105,0
0,0,1484,750,2,1.9760319573901464,2234,744.6666666666666,0
0,0,2694,3292,14,0.8180989978742788,5986,399.06666666666666,1
0,1,1227,168,15,7.260355029585799,1395,87.1875,1
0,2,2259,476,20,4.735849056603773,2735,130.23809523809524,1
2,3,269,2003,3,0.1342315369261477,2272,568.0,0
2,2,423,1969,3,0.2147208121827411,2392,598.0,0
0,1,1398,547,16,2.551094890510949,1945,114.41176470588235,0
1,1,552,115,1,4.758620689655173,667,333.5,0
0,2,1816,1349,8,1.3451851851851853,3165,351.6666666666667,0
2,2,2100,703,6,2.9829545454545454,2803,400.42857142857144,0
2,1,356,1186,20,0.2999157540016849,1542,73.42857142857143,0
1,1,1734,496,0,3.488933601609658,2230,2230.0,0
2,3,167,182,33,0.912568306010929,349,10.264705882352942,0
0,0,406,19,58,20.3,425,7.203389830508475,0
1,0,729,655,36,1.111280487804878,1384,37.4054054054054,0
0,3,256,140,51,1.8156028368794326,396,7.615384615384615,0
0,2,865,165,30,5.210843373493976,1030,33.225806451612904,0
1,1,864,458,21,1.8823529411764706,1322,60.09090909090909,0
0,2,231,466,7,0.49464668094218417,697,87.125,0
2,0,1587,256,9,6.175097276264592,1843,184.3,0
0,0,998,113,11,8.75438596491228,1111,92.58333333333333,0
1,2,382,2319,1,0.1646551724137931,2701,1350.5,0
1,0,264,112,73,2.336283185840708,376,5.081081081081081,0
1,1,2109,345,69,6.095375722543353,2454,35.05714285714286,0
0,3,1806,290,3,6.206185567010309,2096,524.0,0
1,2,261,1609,24,0.16211180124223604,1870,74.8,0
1,1,36,422,18,0.0851063829787234,458,24.105263157894736,0
0,1,1632,105,34,15.39622641509434,1737,49.628571428571426,0
2,0,955,8,27,106.11111111111111,963,34.392857142857146,0
0,1,106,1023,3,0.103515625,1129,282.25,0
1,2,885,1002,32,0.8823529411764706,1887,57.18181818181818,0
1,1,601,432,28,1.3879907621247114,1033,35.62068965517241,0
0,3,1489,108,22,13.660550458715596,1597,69.43478260869566,0
2,1,234,371,15,0.6290322580645161,605,37.8125,0
1,1,603,713,92,0.8445378151260504,1316,14.150537634408602,0
1,3,169,973,56,0.1735112936344969,1142,20.035087719298247,0
1,1,3158,65,26,47.84848484848485,3223,119.37037037037037,0
0,1,1508,650,0,2.316436251920123,2158,2158.0,0
1,0,1334,258,16,5.1505791505791505,1592,93.6470588235294,1
2,2,1171,768,36,1.5227568270481144,1939,52.4054054054054,0
1,0,550,835,3,0.6578947368421053,1385,346.25,0
1,2,2567,1931,15,1.3286749482401656,4498,281.125,0
2,3,75,422,6,0.1773049645390071,497,71.0,0
1,3,1625,617,12,2.629449838187702,2242,172.46153846153845,0
0,3,242,249,0,0.968,491,491.0,0
0,2,391,270,4,1.4428044280442804,661,132.2,0
0,2,732,37,18,19.263157894736842,769,40.473684210526315,1
2,2,1526,269,68,5.651851851851852,1795,26.014492753623188,0
1,3,1823,52,20,34.39622641509434,1875,89.28571428571429,1
0,2,876,2657,18,0.3295711060948081,3533,185.94736842105263,0
2,1,515,783,46,0.6568877551020408,1298,27.617021276595743,0
1,0,2928,152,9,19.137254901960784,3080,308.0,0
2,3,283,99,2,2.83,382,127.33333333333333,0
0,0,1625,369,7,4.391891891891892,1994,249.25,0
0,1,946,294,47,3.2067796610169492,1240,25.833333333333332,0
0,2,473,261,33,1.8053435114503817,734,21.58823529411765,0
2,0,1,505,2,0.001976284584980237,506,168.66666666666666,0
2,1,591,1952,32,0.30261136712749614,2543,77.06060606060606,0
0,1,323,671,80,0.4806547619047619,994,12.271604938271604,0
2,0,110,589,1,0.1864406779661017,699,349.5,0
0,3,78,1314,28,0.05931558935361217,1392,48.0,0
0,0,427,3,14,106.75,430,28.666666666666668,1
1,3,953,175,20,5.4147727272727275,1128,53.714285714285715,0
2,2,1817,548,22,3.3096539162112935,2365,102.82608695652173,0
0,3,202,977,44,0.2065439672801636,1179,26.2,0
0,2,552,530,24,1.03954802259887,1082,43.28,0
2,0,497,143,26,3.451388888888889,640,23.703703703703702,0
1,2,720,2127,12,0.3383458646616541,2847,219.0,0
1,1,1658,318,4,5.197492163009405,1976,395.2,1
0,2,806,1241,34,0.6489533011272142,2047,58.48571428571429,0
2,3,1875,1776,0,1.0551491277433878,3651,3651.0,0
1,3,730,340,11,2.1407624633431084,1070,89.16666666666667,0
2,3,925,1493,7,0.6191432396251674,2418,302.25,0
2,2,575,992,14,0.5790533736153072,1567,104.46666666666667,0
0,3,1732,1877,11,0.9222577209797657,3609,300.75,0
1,3,2574,231,36,11.094827586206897,2805,75.8108108108108,0
0,1,1019,2142,9,0.4755016332244517,3161,316.1,0
1,2,1719,54,24,31.254545454545454,1773,70.92,1
1,1,60,1262,18,0.047505938242280284,1322,69.57894736842105,0
1,3,2365,457,48,5.163755458515284,2822,57.59183673469388,0
1,3,209,156,16,1.3312101910828025,365,21.470588235294116,0
1,3,296,66,59,4.417910447761194,362,6.033333333333333,1
2,2,54,394,0,0.13670886075949368,448,448.0,0
0,0,3363,394,27,8.51392405063291,3757,134.17857142857142,1
2,3,1910,209,0,9.095238095238095,2119,2119.0,0
1,3,2443,194,37,12.528205128205128,2637,69.39473684210526,1
0,3,1878,408,8,4.591687041564792,2286,254.0,0
1,3,653,422,14,1.5437352245862883,1075,71.66666666666667,0
0,2,2578,467,14,5.5085470085470085,3045,203.0,0
2,0,3489,1624,56,2.147076923076923,5113,89.70175438596492,0
0,0,698,755,3,0.9232804232804233,1453,363.25,0
0,0,193,16,32,11.352941176470589,209,6.333333333333333,1
0,3,1074,585,119,1.8327645051194539,1659,13.825,0
0,3,3706,1149,0,3.222608695652174,4855,4855.0,1
0,0,2056,46,101,43.744680851063826,2102,20.607843137254903,0
1,0,1979,439,0,4.497727272727273,2418,2418.0,0
0,3,2715,480,55,5.644490644490644,3195,57.05357142857143,1
0,3,2243,2463,97,0.9103084415584416,4706,48.02040816326531,0
2,1,1497,516,148,2.895551257253385,2013,13.51006711409396,0
0,1,1266,1108,18,1.1415689810640217,2374,124.94736842105263,0
2,1,307,288,60,1.0622837370242215,595,9.754098360655737,0
1,0,971,1208,3,0.8031430934656741,2179,544.75,0
0,2,737,311,16,2.3621794871794872,1048,61.64705882352941,0
2,3,1980,449,11,4.4,2429,202.41666666666666,0
2,1,676,522,15,1.2925430210325048,1198,74.875,0
1,2,136,2086,36,0.06516530905606133,2222,60.054054054054056,0
0,3,4,43,2,0.09090909090909091,47,15.666666666666666,0
0,2,1132,175,189,6.431818181818182,1307,6.878947368421053,0
2,0,798,978,30,0.81511746680286,1776,57.29032258064516,0
0,0,401,689,62,0.5811594202898551,1090,17.3015873015873,0
2,0,185,231,53,0.7974137931034483,416,7.703703703703703,0
0,1,628,273,43,2.291970802919708,901,20.477272727272727,0
2,3,105,366,1,0.28610354223433243,471,235.5,0
0,0,409,478,21,0.8538622129436325,887,40.31818181818182,0
1,1,476,1363,11,0.3489736070381232,1839,153.25,0
0,1,626,11,3,52.166666666666664,637,159.25,0
0,1,628,1826,12,0.3437328954570334,2454,188.76923076923077,0
1,1,297,426,31,0.6955503512880562,723,22.59375,0
0,0,1898,209,7,9.038095238095238,2107,263.375,0
1,1,439,568,17,0.7715289982425307,1007,55.94444444444444,0
0,0,260,862,15,0.30127462340672073,1122,70.125,0
2,0,193,36,1,5.216216216216216,229,114.5,0
2,1,389,1006,29,0.38629592850049654,1395,46.5,0
0,0,69,1144,28,0.06026200873362445,1213,41.827586206896555,0
0,3,33,145,101,0.22602739726027396,178,1.7450980392156863,0
0,3,929,147,10,6.277027027027027,1076,97.81818181818181,0
2,2,965,182,16,5.273224043715847,1147,67.47058823529412,0
0,3,754,1274,15,0.5913725490196079,2028,126.75,0
2,0,1436,253,75,5.653543307086614,1689,22.223684210526315,0
1,0,39,1271,15,0.030660377358490566,1310,81.875,0
2,3,2748,622,17,4.41091492776886,3370,187.22222222222223,0
2,1,99,1165,8,0.08490566037735849,1264,140.44444444444446,0
1,1,1120,645,0,1.7337461300309598,1765,1765.0,0
2,0,143,327,3,0.43597560975609756,470,117.5,0
0,1,2119,1932,36,1.0962234868080702,4051,109.48648648648648,0
0,2,714,1005,34,0.709741550695825,1719,49.114285714285714,0
2,2,85,529,11,0.16037735849056603,614,51.166666666666664,0
0,3,959,811,19,1.1810344827586208,1770,88.5,0
2,3,9,765,10,0.01174934725848564,774,70.36363636363636,0
0,1,1496,354,39,4.214084507042253,1850,46.25,1
0,0,1051,441,55,2.3778280542986425,1492,26.642857142857142,0
2,3,239,306,68,0.7785016286644951,545,7.898550724637682,0
0,2,469,6110,5,0.07674684994272624,6579,1096.5,1
2,3,7,694,35,0.010071942446043165,701,19.47222222222222,0
0,3,1183,77,98,15.166666666666666,1260,12.727272727272727,0
0,2,389,585,31,0.6638225255972696,974,30.4375,0
1,0,847,41,12,20.166666666666668,888,68.3076923076923,0
1,3,3140,272,30,11.501831501831502,3412,110.06451612903226,0
2,3,355,472,34,0.7505285412262156,827,23.62857142857143,0
1,3,4629,611,15,7.563725490196078,5240,327.5,0
2,1,1001,2989,3,0.3347826086956522,3990,997.5,0
1,3,277,3223,27,0.0859181141439206,3500,125.0,0
0,2,574,82,48,6.9156626506024095,656,13.387755102040817,0
2,0,1348,617,180,2.1812297734627832,1965,10.856353591160222,0
2,0,591,1359,7,0.4345588235294118,1950,243.75,0
0,2,70,217,36,0.3211009174311927,287,7.756756756756757,0
2,1,184,1110,0,0.16561656165616562,1294,1294.0,0
2,2,1566,1687,105,0.9277251184834123,3253,30.68867924528302,0
1,0,1045,868,0,1.2025316455696202,1913,1913.0,1
2,2,843,317,13,2.650943396226415,1160,82.85714285714286,0
0,1,183,2052,2,0.08913784705309304,2235,745.0,0
1,0,1818,1720,29,1.0563625798954097,3538,117.93333333333334,0
1,1,3237,1006,12,3.2144985104270107,4243,326.38461538461536,1
0,2,41,361,39,0.1132596685082873,402,10.05,0
0,3,81,1255,19,0.06449044585987261,1336,66.8,0
1,2,2160,303,16,7.105263157894737,2463,144.88235294117646,0
2,1,1690,233,12,7.222222222222222,1923,147.92307692307693,0
1,2,962,578,2,1.6614853195164077,1540,513.3333333333334,0
0,3,2899,4684,6,0.6187833511205977,7583,1083.2857142857142,1
1,1,1039,1305,30,0.7955589586523737,2344,75.61290322580645,0
0,2,243,1046,20,0.23209169054441262,1289,61.38095238095238,0
1,1,1304,481,2,2.7053941908713695,1785,595.0,0
2,1,1037,299,23,3.4566666666666666,1336,55.666666666666664,0
1,0,4250,1549,1,2.7419354838709675,5799,2899.5,0
1,0,240,670,21,0.35767511177347244,910,41.36363636363637,0
0,1,911,1342,100,0.6783320923306031,2253,22.306930693069308,0
0,2,1514,535,11,2.824626865671642,2049,170.75,0
0,2,413,1121,38,0.3680926916221034,1534,39.333333333333336,0
1,2,477,1618,41,0.29462631253860405,2095,49.88095238095238,0
2,3,2188,397,15,5.49748743718593,2585,161.5625,0
0,1,517,10,26,47.0,527,19.51851851851852,1
0,1,980,235,19,4.1525423728813555,1215,60.75,0
1,3,2200,1971,9,1.1156186612576064,4171,417.1,0
0,1,235,930,42,0.25241675617615467,1165,27.093023255813954,0
2,1,4010,1069,36,3.7476635514018692,5079,137.27027027027026,1
2,3,1210,314,69,3.8412698412698414,1524,21.771428571428572,0
0,0,685,966,28,0.7083764219234746,1651,56.93103448275862,0
0,1,563,831,14,0.6766826923076923,1394,92.93333333333334,0
1,3,3087,157,37,19.537974683544302,3244,85.36842105263158,0
2,2,230,2771,28,0.08297258297258298,3001,103.48275862068965,0
2,0,373,349,28,1.0657142857142856,722,24.896551724137932,0
0,2,367,319,56,1.146875,686,12.035087719298245,0
1,1,341,368,72,0.924119241192412,709,9.712328767123287,0
2,0,632,76,5,8.207792207792208,708,118.0,0
2,3,4526,784,11,5.765605095541401,5310,442.5,0
1,1,2196,218,31,10.027397260273972,2414,75.4375,0
1,3,397,1300,24,0.3051498847040738,1697,67.88,0
2,0,549,400,31,1.3690773067331672,949,29.65625,0
2,2,1107,490,17,2.254582484725051,1597,88.72222222222223,0
1,1,17,831,15,0.020432692307692308,848,53.0,0
2,1,1715,1147,3,1.4939024390243902,2862,715.5,0
0,3,2118,210,29,10.037914691943127,2328,77.6,0
0,0,1946,2712,5,0.7172871360117951,4658,776.3333333333334,0
1,3,470,778,33,0.6033376123234917,1248,36.705882352941174,0
1,0,619,4,102,123.8,623,6.048543689320389,0
1,1,12,429,8,0.027906976744186046,441,49.0,0
0,0,509,459,4,1.1065217391304347,968,193.6,0
2,1,616,1325,0,0.4645550527903469,1941,1941.0,0
0,0,2374,291,14,8.13013698630137,2665,177.66666666666666,0
2,2,2244,321,7,6.968944099378882,2565,320.625,0
0,0,3384,58,20,57.355932203389834,3442,163.9047619047619,0
2,2,2163,266,22,8.101123595505618,2429,105.6086956521739,0
0,0,8,1009,12,0.007920792079207921,1017,78.23076923076923,0
1,0,1025,805,41,1.271712158808933,1830,43.57142857142857,0
0,3,70,67,70,1.0294117647058822,137,1.9295774647887325,0
2,3,318,97,7,3.2448979591836733,415,51.875,0
0,1,863,378,54,2.2770448548812663,1241,22.563636363636363,0
0,3,1206,1089,4,1.1064220183486237,2295,459.0,0
0,0,1063,1431,7,0.74231843575419,2494,311.75,0
1,3,50,11,24,4.166666666666667,61,2.44,0
0,0,109,319,10,0.340625,428,38.90909090909091,0
1,2,137,441,1,0.30995475113122173,578,289.0,0
1,0,95,1936,10,0.049044914816726896,2031,184.63636363636363,0
0,1,196,556,70,0.3518850987432675,752,10.591549295774648,0
0,2,1166,251,5,4.626984126984127,1417,236.16666666666666,1
0,1,1776,395,43,4.484848484848484,2171,49.34090909090909,1
2,1,525,458,38,1.1437908496732025,983,25.205128205128204,0
0,1,1180,886,3,1.3303269447576098,2066,516.5,0
1,3,223,33,11,6.5588235294117645,256,21.333333333333332,0
0,1,3622,394,6,9.169620253164556,4016,573.7142857142857,0
2,2,430,832,0,0.5162064825930373,1262,1262.0,0
0,0,1869,266,5,7.0,2135,355.8333333333333,0
2,1,2907,716,6,4.054393305439331,3623,517.5714285714286,0
2,2,2000,353,5,5.649717514124294,2353,392.1666666666667,0
0,1,69,1137,2,0.06063268892794376,1206,402.0,0
1,0,1050,50,22,20.58823529411765,1100,47.82608695652174,0
2,2,127,2000,11,0.06346826586706647,2127,177.25,0
0,2,5,150,71,0.033112582781456956,155,2.1527777777777777,0
0,0,53,138,6,0.381294964028777,191,27.285714285714285,0
1,2,2478,1469,27,1.6857142857142857,3947,140.96428571428572,0
2,0,2391,1627,69,1.4686732186732188,4018,57.4,0
2,2,255,78,1,3.2278481012658227,333,166.5,1
0,2,791,1915,21,0.41283924843423797,2706,123.0,0
0,0,3101,255,17,12.11328125,3356,186.44444444444446,0
1,0,686,771,79,0.8886010362694301,1457,18.2125,0
1,2,500,56,32,8.771929824561404,556,16.848484848484848,0
2,2,660,383,12,1.71875,1043,80.23076923076923,0
2,0,1561,479,37,3.252083333333333,2040,53.68421052631579,0
0,3,648,732,26,0.8840381991814461,1380,51.111111111111114,0
2,0,1529,596,12,2.561139028475712,2125,163.46153846153845,0
1,2,565,495,46,1.1391129032258065,1060,22.5531914893617,0
1,2,290,2567,33,0.11292834890965732,2857,84.02941176470588,0
0,2,395,163,0,2.408536585365854,558,558.0,0
1,0,81,137,60,0.5869565217391305,218,3.5737704918032787,0
1,2,687,999,15,0.687,1686,105.375,0
1,3,160,61,31,2.5806451612903225,221,6.90625,0
1,1,1668,527,15,3.159090909090909,2195,137.1875,0
0,3,545,529,63,1.028301886792453,1074,16.78125,0
0,0,1448,296,31,4.875420875420875,1744,54.5,0
2,2,3089,2132,25,1.4481950304735114,5221,200.80769230769232,1
1,0,1893,265,117,7.116541353383458,2158,18.28813559322034,0
2,1,3025,272,9,11.08058608058608,3297,329.7,0
0,0,839,213,2,3.9205607476635516,1052,350.6666666666667,1
0,2,180,126,21,1.4173228346456692,306,13.909090909090908,0
0,1,2739,362,16,7.545454545454546,3101,182.41176470588235,0
0,1,2028,913,18,2.2188183807439823,2941,154.78947368421052,0
0,2,1998,1084,29,1.8414746543778802,3082,102.73333333333333,0
0,2,1181,1343,28,0.8787202380952381,2524,87.03448275862068,0
0,2,980,176,14,5.536723163841808,1156,77.06666666666666,0
1,0,14,29,59,0.4666666666666667,43,0.7166666666666667,0
2,3,1378,2941,31,0.46838885112168593,4319,134.96875,0
0,0,95,11,66,7.916666666666667,106,1.5820895522388059,0
1,0,300,2588,73,0.11587485515643106,2888,39.027027027027025,0
1,3,801,1412,5,0.5668789808917197,2213,368.8333333333333,0
2,2,600,1945,34,0.30832476875642345,2545,72.71428571428571,0
0,2,15,391,11,0.03826530612244898,406,33.833333333333336,0
2,3,1737,175,54,9.869318181818182,1912,34.763636363636365,1
0,3,2110,746,39,2.824631860776439,2856,71.4,0
1,0,1145,1081,6,1.0582255083179297,2226,318.0,0
1,1,778,112,83,6.884955752212389,890,10.595238095238095,0
1,3,3237,1278,34,2.530883502736513,4515,129.0,1
1,0,127,187,89,0.675531914893617,314,3.488888888888889,0
2,1,1339,541,6,2.470479704797048,1880,268.57142857142856,0
0,2,137,1553,61,0.08815958815958816,1690,27.258064516129032,0
0,2,481,171,33,2.796511627906977,652,19.176470588235293,0
2,0,880,221,24,3.963963963963964,1101,44.04,0
0,0,1335,51,51,25.673076923076923,1386,26.653846153846153,0
1,3,3,126,30,0.023622047244094488,129,4.161290322580645,0
0,2,301,126,33,2.37007874015748,427,12.558823529411764,0
1,0,772,181,8,4.241758241758242,953,105.88888888888889,0
2,2,761,269,50,2.8185185185185184,1030,20.19607843137255,0
0,2,1015,1349,31,0.7518518518518519,2364,73.875,0
2,3,362,1979,55,0.18282828282828284,2341,41.80357142857143,0
0,1,777,417,12,1.8588516746411483,1194,91.84615384615384,0
1,3,210,109,12,1.9090909090909092,319,24.53846153846154,0
2,0,206,202,0,1.0147783251231528,408,408.0,0
0,3,859,1066,43,0.8050609184629803,1925,43.75,0
1,3,1156,905,12,1.2759381898454747,2061,158.53846153846155,0
2,2,128,2734,11,0.04680073126142596,2862,238.5,0
2,3,131,11,35,10.916666666666666,142,3.9444444444444446,0
0,0,833,1111,8,0.7491007194244604,1944,216.0,0
0,1,314,563,71,0.5567375886524822,877,12.180555555555555,0
0,3,498,1863,23,0.26716738197424894,2361,98.375,0
1,3,512,686,104,0.745269286754003,1198,11.40952380952381,0
0,1,196,473,2,0.41350210970464135,669,223.0,0
2,0,1,876,12,0.0011402508551881414,877,67.46153846153847,0
2,0,1918,1434,14,1.3365853658536586,3352,223.46666666666667,0
0,3,1255,265,39,4.7180451127819545,1520,38.0,1
0,2,1172,91,7,12.73913043478261,1263,157.875,0
2,3,790,453,14,1.7400881057268722,1243,82.86666666666666,0
1,1,1207,193,72,6.221649484536083,1400,19.17808219178082,1
0,1,2744,449,3,6.097777777777778,3193,798.25,0
0,1,1095,3772,41,0.29021998409753513,4867,115.88095238095238,0
2,3,308,682,36,0.45095168374816985,990,26.756756756756758,0
0,3,845,946,4,0.8922914466737064,1791,358.2,0
1,0,583,906,34,0.6427783902976847,1489,42.542857142857144,0
2,2,812,1374,25,0.5905454545454546,2186,84.07692307692308,0
0,3,729,2307,10,0.3158578856152513,3036,276.0,0
2,0,1957,860,11,2.272938443670151,2817,234.75,0
0,3,1054,517,53,2.034749034749035,1571,29.09259259259259,0
0,0,209,305,7,0.6830065359477124,514,64.25,0
0,0,65,357,21,0.18156424581005587,422,19.181818181818183,0
1,2,552,325,34,1.6932515337423313,877,25.057142857142857,0
1,3,15,313,4,0.04777070063694268,328,65.6,0
2,0,383,948,80,0.4035827186512118,1331,16.432098765432098,0
0,1,458,708,9,0.6459802538787024,1166,116.6,0
0,1,470,180,11,2.596685082872928,650,54.166666666666664,0
1,1,3880,2795,32,1.3876967095851216,6675,202.27272727272728,1
0,2,362,446,2,0.8098434004474273,808,269.3333333333333,0
1,0,308,667,29,0.46107784431137727,975,32.5,0
0,2,138,970,74,0.14212152420185376,1108,14.773333333333333,0
2,3,715,760,8,0.9395532194480947,1475,163.88888888888889,0
0,3,166,298,13,0.5551839464882943,464,33.142857142857146,0
0,0,957,1278,7,0.7482408131352619,2235,279.375,0
1,1,168,93,51,1.7872340425531914,261,5.019230769230769,0
0,0,859,673,5,1.274480712166172,1532,255.33333333333334,0
0,0,1750,255,12,6.8359375,2005,154.23076923076923,1
1,0,43,765,27,0.05613577023498695,808,28.857142857142858,0
2,2,544,196,15,2.761421319796954,740,46.25,0
2,3,618,1183,2,0.5219594594594594,1801,600.3333333333334,0
1,0,1565,206,88,7.5603864734299515,1771,19.89887640449438,0
1,0,630,1768,12,0.3561334087054833,2398,184.46153846153845,0
1,0,838,1581,17,0.5297092288242731,2419,134.38888888888889,0
1,2,1566,360,5,4.337950138504155,1926,321.0,1
1,2,820,389,60,2.1025641025641026,1209,19.81967213114754,0
2,2,443,967,10,0.45764462809917356,1410,128.1818181818182,0
2,0,89,75,0,1.1710526315789473,164,164.0,0
1,1,1309,67,11,19.25,1376,114.66666666666667,0
0,1,2049,117,124,17.364406779661017,2166,17.328,1
1,1,3508,661,4,5.2990936555891235,4169,833.8,0
0,3,2611,129,0,20.084615384615386,2740,2740.0,1
1,0,1596,260,25,6.114942528735632,1856,71.38461538461539,1
1,1,1031,832,13,1.2376950780312126,1863,133.07142857142858,0
2,1,1520,12,47,116.92307692307692,1532,31.916666666666668,0
0,1,565,158,39,3.5534591194968552,723,18.075,0
0,0,903,2126,6,0.4245416078984485,3029,432.7142857142857,0
2,1,428,871,24,0.4908256880733945,1299,51.96,0
2,1,395,291,0,1.3527397260273972,686,686.0,0
2,0,1413,37,17,37.18421052631579,1450,80.55555555555556,0
2,3,605,705,37,0.8569405099150141,1310,34.473684210526315,0
0,2,238,201,16,1.1782178217821782,439,25.823529411764707,0
0,1,225,2578,3,0.08724311748739821,2803,700.75,0
1,2,1960,929,1,2.10752688172043,2889,1444.5,0
1,3,1132,2923,57,0.387140902872777,4055,69.91379310344827,0
2,3,789,1511,66,0.5218253968253969,2300,34.32835820895522,0
2,1,512,527,12,0.9696969696969697,1039,79.92307692307692,0
2,0,563,885,5,0.6354401805869074,1448,241.33333333333334,0
1,3,59,1337,115,0.044095665171898356,1396,12.03448275862069,0
1,2,606,690,23,0.8769898697539797,1296,54.0,0
1,2,1586,50,19,31.098039215686274,1636,81.8,1
1,2,491,508,40,0.9646365422396856,999,24.365853658536587,0
1,2,483,111,5,4.3125,594,99.0,1
1,3,15,1003,26,0.014940239043824702,1018,37.7037037037037,0
1,1,612,913,66,0.6695842450765864,1525,22.761194029850746,0
2,1,25,3959,0,0.006313131313131313,3984,3984.0,1
2,2,844,792,33,1.064312736443884,1636,48.11764705882353,0
2,1,706,1288,24,0.547711404189294,1994,79.76,0
2,2,1832,249,90,7.328,2081,22.86813186813187,0
1,2,871,332,8,2.6156156156156154,1203,133.66666666666666,0
0,0,390,1991,58,0.19578313253012047,2381,40.355932203389834,0
1,3,726,1125,11,0.6447602131438721,1851,154.25,0
0,3,1202,851,16,1.4107981220657277,2053,120.76470588235294,0
2,2,98,234,7,0.41702127659574467,332,41.5,0
1,3,970,959,59,1.0104166666666667,1929,32.15,0
2,1,2484,1742,6,1.4251290877796903,4226,603.7142857142857,0
1,2,355,209,58,1.6904761904761905,564,9.559322033898304,0
2,0,985,979,18,1.0051020408163265,1964,103.36842105263158,0
0,1,1722,400,54,4.29426433915212,2122,38.58181818181818,0
0,0,717,101,9,7.029411764705882,818,81.8,0
0,0,1265,1153,4,1.0961871750433276,2418,483.6,0
1,3,372,146,24,2.5306122448979593,518,20.72,0
0,3,365,233,21,1.5598290598290598,598,27.181818181818183,0
1,2,1101,1222,13,0.9002452984464432,2323,165.92857142857142,0
0,3,1222,1084,32,1.1262672811059908,2306,69.87878787878788,0
0,0,2764,234,2,11.761702127659575,2998,999.3333333333334,0
1,0,254,2263,29,0.11219081272084806,2517,83.9,0
1,1,631,193,7,3.252577319587629,824,103.0,0
0,0,288,4043,4,0.0712166172106825,4331,866.2,1
1,2,83,1071,72,0.07742537313432836,1154,15.808219178082192,0
0,2,516,398,18,1.2932330827067668,914,48.10526315789474,0
1,3,468,111,43,4.178571428571429,579,13.159090909090908,0
2,3,315,309,2,1.0161290322580645,624,208.0,0
2,3,352,172,1,2.0346820809248554,524,262.0,0
2,2,446,777,20,0.5732647814910026,1223,58.23809523809524,0
2,0,4495,353,11,12.69774011299435,4848,404.0,0
2,3,1527,279,0,5.453571428571428,1806,1806.0,1
0,1,74,1132,6,0.06531332744924978,1206,172.28571428571428,0
2,3,2058,209,7,9.8,2267,283.375,0
2,2,1003,707,10,1.4166666666666667,1710,155.45454545454547,0
2,3,2212,173,62,12.71264367816092,2385,37.857142857142854,1
2,0,418,1003,16,0.4163346613545817,1421,83.58823529411765,0
1,3,624,784,34,0.7949044585987262,1408,40.22857142857143,0
0,2,2265,1280,0,1.7681498829039812,3545,3545.0,0
2,2,318,56,50,5.578947368421052,374,7.333333333333333,0
2,1,2471,188,8,13.074074074074074,2659,295.44444444444446,0
2,2,1763,134,11,13.059259259259258,1897,158.08333333333334,0
0,1,3940,169,1,23.176470588235293,4109,2054.5,0
1,0,391,86,15,4.494252873563219,477,29.8125,1
0,2,268,660,57,0.405446293494705,928,16.0,0
1,3,401,720,14,0.5561719833564494,1121,74.73333333333333,0
2,0,3093,1483,71,2.084231805929919,4576,63.55555555555556,0
2,3,405,432,60,0.9353348729792148,837,13.721311475409836,0
0,3,832,608,1,1.3661740558292284,1440,720.0,0
0,3,516,3795,10,0.13593256059009484,4311,391.90909090909093,0
1,0,504,607,72,0.8289473684210527,1111,15.219178082191782,0
1,0,214,681,0,0.31378299120234604,895,895.0,0
0,2,770,4400,43,0.17496023630992957,5170,117.5,0
1,3,1893,4110,71,0.4604719046460715,6003,83.375,1
0,1,50,441,44,0.11312217194570136,491,10.911111111111111,0
1,2,2200,806,40,2.7261462205700124,3006,73.3170731707317,0
0,0,1095,524,55,2.085714285714286,1619,28.910714285714285,0
0,1,959,1020,32,0.9392752203721841,1979,59.96969696969697,0
0,0,983,2229,16,0.4408071748878924,3212,188.94117647058823,0
1,1,351,296,1,1.1818181818181819,647,323.5,0
1,2,536,1366,46,0.3920994879297732,1902,40.46808510638298,0
1,1,1605,851,70,1.8838028169014085,2456,34.59154929577465,0
0,2,365,263,21,1.3825757575757576,628,28.545454545454547,0
1,0,634,1276,22,0.4964761158966327,1910,83.04347826086956,0
1,1,19,445,15,0.042600896860986545,464,29.0,0
0,3,1322,102,58,12.83495145631068,1424,24.135593220338983,0
2,3,540,4018,0,0.13436178153769596,4558,4558.0,1
0,0,745,443,29,1.677927927927928,1188,39.6,0
1,1,121,623,71,0.19391025641025642,744,10.333333333333334,0
0,3,4793,1320,3,3.6283118849356546,6113,1528.25,1
2,2,360,2592,95,0.13883532587736214,2952,30.75,0
0,1,1007,1650,102,0.6099333737129012,2657,25.796116504854368,0
1,1,870,595,79,1.4597315436241611,1465,18.3125,0
2,3,1537,631,18,2.4319620253164556,2168,114.10526315789474,0
1,2,347,263,14,1.3143939393939394,610,40.666666666666664,0
2,2,1410,497,36,2.8313253012048194,1907,51.54054054054054,0
2,2,482,2347,11,0.20528109028960817,2829,235.75,0
0,1,529,1038,2,0.5091434071222329,1567,522.3333333333334,0
0,0,1116,9,69,111.6,1125,16.071428571428573,0
1,1,1533,99,30,15.33,1632,52.645161290322584,0
0,1,1099,2059,6,0.5334951456310679,3158,451.14285714285717,0
0,3,2301,1510,0,1.5228325612177367,3811,3811.0,0
2,0,335,532,38,0.6285178236397748,867,22.23076923076923,0
0,2,2308,767,57,3.0052083333333335,3075,53.01724137931034,0
2,3,140,273,15,0.5109489051094891,413,25.8125,0
2,1,1077,1259,2,0.8547619047619047,2336,778.6666666666666,0
2,0,793,739,31,1.0716216216216217,1532,47.875,0
1,2,682,949,10,0.7178947368421053,1631,148.27272727272728,0
1,2,372,375,4,0.9893617021276596,747,149.4,0
1,1,700,450,21,1.5521064301552105,1150,52.27272727272727,0
2,2,176,186,19,0.9411764705882353,362,18.1,0
1,2,460,2366,21,0.19433882551753273,2826,128.45454545454547,0
1,0,103,2343,52,0.0439419795221843,2446,46.15094339622642,0
0,3,848,1361,19,0.6226138032305433,2209,110.45,0
1,0,100,2193,69,0.04557885141294439,2293,32.75714285714286,0
1,3,174,875,55,0.19863013698630136,1049,18.732142857142858,0
2,3,89,213,31,0.4158878504672897,302,9.4375,0
2,3,480,1142,1,0.4199475065616798,1622,811.0,0
2,2,1844,314,60,5.853968253968254,2158,35.377049180327866,0
2,0,2374,464,70,5.105376344086022,2838,39.971830985915496,0
2,2,74,256,14,0.28793774319066145,330,22.0,0
2,1,1006,440,22,2.2811791383219955,1446,62.869565217391305,0
1,0,1153,909,9,1.267032967032967,2062,206.2,0
2,3,763,93,0,8.117021276595745,856,856.0,0
2,2,1099,88,19,12.348314606741573,1187,59.35,1
0,2,266,921,4,0.2885032537960954,1187,237.4,0
1,0,672,1209,6,0.5553719008264463,1881,268.7142857142857,0
1,0,495,641,19,0.7710280373831776,1136,56.8,0
1,3,93,160,60,0.577639751552795,253,4.147540983606557,0
2,3,982,450,55,2.1773835920177382,1432,25.571428571428573,0
2,1,683,1135,100,0.6012323943661971,1818,18.0,0
2,3,321,926,19,0.34627831715210355,1247,62.35,0
0,2,641,93,24,6.819148936170213,734,29.36,0
2,1,1492,2782,51,0.5361121092346389,4274,82.1923076923077,0
0,1,1617,202,36,7.9655172413793105,1819,49.16216216216216,1
1,1,1048,199,6,5.24,1247,178.14285714285714,0
2,0,630,492,15,1.2778904665314401,1122,70.125,0
0,3,857,317,79,2.6949685534591197,1174,14.675,0
0,1,486,3307,4,0.14691656590084642,3793,758.6,0
2,0,135,63,7,2.109375,198,24.75,0
1,0,487,292,15,1.6621160409556315,779,48.6875,0
1,1,755,385,84,1.955958549222798,1140,13.411764705882353,0
1,1,913,544,3,1.6752293577981652,1457,364.25,0
0,2,2745,13,33,196.07142857142858,2758,81.11764705882354,0
0,1,1502,68,4,21.768115942028984,1570,314.0,0
0,2,164,238,22,0.6861924686192469,402,17.47826086956522,0
0,1,191,645,23,0.29566563467492263,836,34.833333333333336,0
1,1,105,1168,1,0.08982035928143713,1273,636.5,0
2,3,1340,927,92,1.4439655172413792,2267,24.376344086021504,0
0,1,1224,669,49,1.826865671641791,1893,37.86,0
0,1,4294,404,10,10.602469135802469,4698,427.09090909090907,1
1,2,738,1636,4,0.4508246792913867,2374,474.8,0
2,2,1751,492,12,3.5517241379310347,2243,172.53846153846155,0
2,3,859,284,67,3.0140350877192983,1143,16.808823529411764,0
1,1,2072,793,4,2.6095717884130982,2865,573.0,0
1,1,1276,942,12,1.3531283138918346,2218,170.6153846153846,0
2,2,1029,406,20,2.5282555282555284,1435,68.33333333333333,0
0,0,832,22,1,36.17391304347826,854,427.0,1
2,0,1283,79,9,16.0375,1362,136.2,0
1,0,544,1494,27,0.36387959866220737,2038,72.78571428571429,0
0,2,101,46,11,2.148936170212766,147,12.25,0
0,2,40,717,61,0.055710306406685235,757,12.209677419354838,0
1,0,652,162,82,4.0,814,9.80722891566265,1
1,0,914,207,17,4.394230769230769,1121,62.27777777777778,0
1,1,82,255,22,0.3203125,337,14.652173913043478,0
2,2,338,31,29,10.5625,369,12.3,0
2,2,388,156,32,2.4713375796178343,544,16.484848484848484,0
0,0,827,841,1,0.982185273159145,1668,834.0,0
1,0,326,552,1,0.5895117540687161,878,439.0,0
0,3,100,1276,60,0.07830853563038372,1376,22.557377049180328,0
0,2,180,50,7,3.5294117647058822,230,28.75,0
0,3,191,1757,26,0.10864618885096701,1948,72.14814814814815,0
0,1,1849,4501,29,0.4107063527321191,6350,211.66666666666666,1
1,3,334,12,5,25.692307692307693,346,57.666666666666664,0
0,0,1254,2744,43,0.4568306010928962,3998,90.86363636363636,0
1,2,838,215,60,3.8796296296296298,1053,17.262295081967213,1
1,2,3773,943,10,3.996822033898305,4716,428.72727272727275,1
2,3,318,276,63,1.148014440433213,594,9.28125,0
1,3,172,590,2,0.2910321489001692,762,254.0,0
2,1,53,571,48,0.09265734265734266,624,12.73469387755102,0
1,1,275,358,30,0.766016713091922,633,20.419354838709676,0
1,0,1152,1011,26,1.1383399209486167,2163,80.11111111111111,0
1,0,89,732,7,0.12141882673942701,821,102.625,0
2,0,280,567,13,0.49295774647887325,847,60.5,0
2,3,1933,3252,72,0.5942207193359975,5185,71.02739726027397,1
0,3,874,2250,18,0.38827187916481565,3124,164.42105263157896,0
2,2,72,2488,27,0.02892728003214142,2560,91.42857142857143,0
2,0,48,1705,82,0.02813599062133646,1753,21.120481927710845,0
2,3,63,235,18,0.2669491525423729,298,15.68421052631579,0
2,2,2845,344,14,8.246376811594203,3189,212.6,0
0,0,1896,210,67,8.985781990521327,2106,30.970588235294116,1
2,1,1863,3425,72,0.5437828371278459,5288,72.43835616438356,0
1,1,2579,132,13,19.39097744360902,2711,193.64285714285714,0
1,3,703,365,26,1.9207650273224044,1068,39.55555555555556,0
2,2,284,177,99,1.595505617977528,461,4.61,0
2,1,513,202,1,2.5270935960591134,715,357.5,0
1,2,1268,227,1,5.56140350877193,1495,747.5,0
1,2,2087,816,21,2.554467564259486,2903,131.95454545454547,0
0,1,571,63,10,8.921875,634,57.63636363636363,0
1,2,766,679,26,1.1264705882352941,1445,53.51851851851852,0
1,1,2685,1368,38,1.9612856099342586,4053,103.92307692307692,0
2,3,113,1163,2,0.09707903780068729,1276,425.3333333333333,0
1,0,1982,131,64,15.015151515151516,2113,32.50769230769231,1
0,0,173,1969,9,0.08781725888324873,2142,214.2,0
1,3,661,1176,14,0.5615972812234494,1837,122.46666666666667,0
2,1,246,4,12,49.2,250,19.23076923076923,1
2,1,923,1069,54,0.8626168224299066,1992,36.21818181818182,0
1,1,817,1069,5,0.7635514018691589,1886,314.3333333333333,0
2,1,478,549,0,0.8690909090909091,1027,1027.0,0
0,3,1989,37,107,52.3421052631579,2026,18.75925925925926,1
0,0,1078,693,118,1.553314121037464,1771,14.882352941176471,0
1,2,1277,1161,8,1.0989672977624785,2438,270.8888888888889,0
1,2,163,252,0,0.6442687747035574,415,415.0,0
1,0,2146,879,31,2.4386363636363635,3025,94.53125,0
2,3,182,349,31,0.52,531,16.59375,0
0,2,252,682,84,0.3689604685212299,934,10.988235294117647,0
0,0,137,388,10,0.35218508997429304,525,47.72727272727273,0
2,3,580,289,6,2.0,869,124.14285714285714,0
0,2,2186,1549,28,1.4103225806451614,3735,128.79310344827587,0
1,1,290,1121,24,0.25846702317290554,1411,56.44,0
1,1,468,339,37,1.3764705882352941,807,21.236842105263158,0
1,3,1871,456,64,4.094091903719913,2327,35.8,1
0,1,961,941,24,1.0201698513800426,1902,76.08,0
1,3,1392,1333,4,1.0434782608695652,2725,545.0,0
2,0,240,922,27,0.2600216684723727,1162,41.5,0
2,0,1260,622,14,2.0224719101123596,1882,125.46666666666667,0
0,2,258,2470,18,0.10441116956697694,2728,143.57894736842104,0
2,3,4367,1190,96,3.6666666666666665,5557,57.28865979381443,1
2,2,820,98,24,8.282828282828282,918,36.72,0
0,2,1189,653,4,1.8180428134556574,1842,368.4,0
1,0,126,421,17,0.2985781990521327,547,30.38888888888889,0
1,2,288,1267,7,0.22712933753943218,1555,194.375,0
1,1,150,36,4,4.054054054054054,186,37.2,0
0,2,494,423,37,1.1650943396226414,917,24.13157894736842,0
2,3,334,306,29,1.0879478827361564,640,21.333333333333332,0
1,1,1320,121,20,10.819672131147541,1441,68.61904761904762,0
1,0,115,380,16,0.30183727034120733,495,29.11764705882353,0
0,3,1394,893,11,1.5592841163310962,2287,190.58333333333334,0
1,1,46,359,2,0.12777777777777777,405,135.0,0
0,3,225,694,10,0.3237410071942446,919,83.54545454545455,0
2,1,1570,718,54,2.1835883171070933,2288,41.6,0
0,3,1357,707,45,1.9166666666666667,2064,44.869565217391305,0
0,3,646,603,107,1.0695364238410596,1249,11.564814814814815,0
0,1,51,99,32,0.51,150,4.545454545454546,0
0,0,941,197,24,4.752525252525253,1138,45.52,0
2,0,522,1287,10,0.4052795031055901,1809,164.45454545454547,0
2,3,380,558,2,0.6797853309481217,938,312.6666666666667,0
1,3,1022,979,28,1.042857142857143,2001,69.0,0
2,0,573,675,20,0.8476331360946746,1248,59.42857142857143,0
2,0,96,31,42,3.0,127,2.953488372093023,0
1,2,2476,1272,15,1.9450117831893166,3748,234.25,0
2,0,1507,53,127,27.90740740740741,1560,12.1875,0
0,3,58,2294,15,0.025272331154684097,2352,147.0,0
0,1,744,194,12,3.8153846153846156,938,72.15384615384616,1
1,0,87,574,61,0.15130434782608695,661,10.661290322580646,0
1,2,1815,52,15,34.24528301886792,1867,116.6875,0
1,2,949,1802,61,0.526344980587909,2751,44.37096774193548,0
0,2,189,3127,0,0.060421994884910485,3316,3316.0,0
2,1,20,126,35,0.15748031496062992,146,4.055555555555555,0
0,0,32,280,2,0.11387900355871886,312,104.0,0
1,0,707,12,4,54.38461538461539,719,143.8,0
2,0,1325,1237,36,1.0702746365105007,2562,69.24324324324324,0
2,1,128,298,10,0.4280936454849498,426,38.72727272727273,0
0,1,250,711,7,0.351123595505618,961,120.125,0
1,3,396,32,48,12.0,428,8.73469387755102,0
0,2,245,1005,87,0.24353876739562624,1250,14.204545454545455,0
2,2,496,603,7,0.8211920529801324,1099,137.375,0
0,0,820,1032,11,0.7938044530493708,1852,154.33333333333334,0
0,1,1154,1246,37,0.92542101042502,2400,63.1578947368421,0
1,1,3318,74,50,44.24,3392,66.50980392156863,0
1,0,2671,690,212,3.8654124457308248,3361,15.779342723004694,0
2,0,844,839,9,1.0047619047619047,1683,168.3,0
0,3,1324,581,24,2.274914089347079,1905,76.2,0
0,2,3013,161,4,18.598765432098766,3174,634.8,0
0,2,87,1270,12,0.06845003933910307,1357,104.38461538461539,0
2,2,5,4779,1,0.0010460251046025104,4784,2392.0,0
2,3,30,2786,7,0.010764262648008612,2816,352.0,0
1,0,828,1202,21,0.6882793017456359,2030,92.27272727272727,0
1,0,1438,433,5,3.313364055299539,1871,311.8333333333333,0
1,2,457,329,66,1.3848484848484848,786,11.73134328358209,0
0,2,787,56,37,13.807017543859649,843,22.18421052631579,0
0,3,726,430,0,1.6844547563805103,1156,1156.0,0
1,1,99,135,62,0.7279411764705882,234,3.7142857142857144,0
0,1,388,234,113,1.651063829787234,622,5.456140350877193,0
1,2,19,1779,20,0.010674157303370787,1798,85.61904761904762,0
2,3,117,2766,11,0.0422840621611854,2883,240.25,0
1,2,1670,2373,9,0.7034540859309183,4043,404.3,0
2,1,1768,171,2,10.279069767441861,1939,646.3333333333334,1
0,2,1619,1849,20,0.8751351351351352,3468,165.14285714285714,0
1,1,1297,122,1,10.544715447154472,1419,709.5,1
0,1,1576,566,21,2.7795414462081127,2142,97.36363636363636,0
2,1,1111,825,8,1.3450363196125907,1936,215.11111111111111,0
2,0,1108,496,19,2.2293762575452716,1604,80.2,0
2,0,1100,2426,16,0.45323444581788214,3526,207.41176470588235,0
0,2,721,324,10,2.2184615384615385,1045,95.0,0
0,1,451,599,17,0.7516666666666667,1050,58.333333333333336,0
0,0,1310,62,19,20.793650793650794,1372,68.6,0
0,2,354,1529,53,0.23137254901960785,1883,34.870370370370374,0
2,2,782,426,32,1.8313817330210773,1208,36.60606060606061,0
2,2,568,964,17,0.5886010362694301,1532,85.11111111111111,0
1,2,323,917,70,0.35185185185185186,1240,17.464788732394368,0
1,2,3676,902,42,4.070874861572536,4578,106.46511627906976,1
0,3,299,565,2,0.5282685512367491,864,288.0,0
2,1,370,260,5,1.417624521072797,630,105.0,0
2,2,176,784,2,0.22420382165605096,960,320.0,0
2,3,1731,2611,11,0.6627105666156202,4342,361.8333333333333,0
1,1,883,1436,17,0.6144745998608212,2319,128.83333333333334,0
1,0,949,92,21,10.204301075268818,1041,47.31818181818182,0
2,2,1717,18,57,90.36842105263158,1735,29.913793103448278,0
2,3,419,552,0,0.7576853526220615,971,971.0,0
2,0,215,1196,16,0.1796157059314954,1411,83.0,0
1,3,221,301,15,0.7317880794701986,522,32.625,0
2,1,1319,966,88,1.3640124095139607,2285,25.674157303370787,0
2,1,952,2149,8,0.4427906976744186,3101,344.55555555555554,0
0,0,231,491,3,0.4695121951219512,722,180.5,0
0,3,156,223,4,0.6964285714285714,379,75.8,0
1,2,128,1998,22,0.064032016008004,2126,92.43478260869566,0
2,2,988,511,14,1.9296875,1499,99.93333333333334,0
2,0,0,419,42,0.0,419,9.744186046511627,0
0,0,18,348,11,0.05157593123209169,366,30.5,0
1,0,493,439,4,1.1204545454545454,932,186.4,0
0,3,1175,895,14,1.3113839285714286,2070,138.0,0
0,2,1187,454,64,2.608791208791209,1641,25.246153846153845,0
0,2,562,313,15,1.7898089171974523,875,54.6875,0
0,2,1174,1088,53,1.0780532598714416,2262,41.888888888888886,0
2,0,736,181,13,4.043956043956044,917,65.5,0
2,2,3769,180,9,20.823204419889503,3949,394.9,0
0,1,177,953,44,0.18553459119496854,1130,25.11111111111111,0
1,0,917,1612,7,0.5685058896466212,2529,316.125,0
1,2,675,220,7,3.0542986425339365,895,111.875,0
1,3,216,169,1,1.2705882352941176,385,192.5,0
1,0,1386,887,6,1.5608108108108107,2273,324.7142857142857,0
0,1,322,775,14,0.41494845360824745,1097,73.13333333333334,0
2,1,480,474,15,1.0105263157894737,954,59.625,0
1,3,469,80,16,5.790123456790123,549,32.294117647058826,0
0,3,279,77,19,3.576923076923077,356,17.8,0
1,0,563,1201,25,0.4683860232945091,1764,67.84615384615384,0
1,0,641,480,6,1.3326403326403327,1121,160.14285714285714,0
0,1,1363,1561,28,0.8725992317541613,2924,100.82758620689656,0
2,3,1448,684,12,2.113868613138686,2132,164.0,0
2,0,172,771,39,0.22279792746113988,943,23.575,0
0,1,898,2176,24,0.41249425815342217,3074,122.96,0
2,3,2265,143,24,15.729166666666666,2408,96.32,0
0,1,115,626,34,0.18341307814992025,741,21.17142857142857,0
0,2,640,47,12,13.333333333333334,687,52.84615384615385,0
0,3,1387,355,16,3.896067415730337,1742,102.47058823529412,1
2,0,945,128,26,7.325581395348837,1073,39.74074074074074,1
0,0,106,166,16,0.6347305389221557,272,16.0,0
1,2,505,2184,17,0.2311212814645309,2689,149.38888888888889,0
2,3,707,754,9,0.9364238410596026,1461,146.1,0
2,1,5483,1781,10,3.0768799102132434,7264,660.3636363636364,1
2,0,196,468,36,0.417910447761194,664,17.945945945945947,0
2,2,4041,728,0,5.54320987654321,4769,4769.0,1
1,2,471,26,3,17.444444444444443,497,124.25,0
2,3,223,507,89,0.4389763779527559,730,8.11111111111111,0
2,3,534,664,6,0.8030075187969925,1198,171.14285714285714,0
0,0,951,13,16,67.92857142857143,964,56.705882352941174,0
2,2,240,1246,56,0.19246190858059342,1486,26.07017543859649,0
1,1,344,280,0,1.2241992882562278,624,624.0,0
1,2,1927,481,77,3.9979253112033195,2408,30.871794871794872,0
1,1,6917,613,1,11.265472312703583,7530,3765.0,1
1,1,382,3882,5,0.09837754313674994,4264,710.6666666666666,1
2,0,161,83,0,1.9166666666666667,244,244.0,0
2,2,1575,648,21,2.426810477657935,2223,101.04545454545455,0
1,1,917,605,85,1.5132013201320131,1522,17.697674418604652,0
1,3,105,57,54,1.8103448275862069,162,2.9454545454545453,0
2,1,2933,803,30,3.648009950248756,3736,120.51612903225806,0
1,3,81,270,6,0.2988929889298893,351,50.142857142857146,0
0,3,981,87,61,11.147727272727273,1068,17.225806451612904,0
1,2,551,157,42,3.4873417721518987,708,16.46511627906977,0
1,3,813,1388,9,0.5853131749460043,2201,220.1,0
0,1,239,87,49,2.715909090909091,326,6.52,0
0,3,1165,503,62,2.3115079365079363,1668,26.476190476190474,0
2,2,3211,173,35,18.45402298850575,3384,94.0,0
2,0,613,141,3,4.316901408450704,754,188.5,0
0,1,740,184,124,4.0,924,7.392,0
0,1,274,543,2,0.5036764705882353,817,272.3333333333333,0
2,2,2224,217,31,10.20183486238532,2441,76.28125,0
1,2,3546,81,3,43.24390243902439,3627,906.75,0
0,2,1543,1293,70,1.1924265842349304,2836,39.943661971830984,0
2,2,782,620,12,1.2592592592592593,1402,107.84615384615384,0
1,1,3141,136,21,22.927007299270073,3277,148.95454545454547,0
0,0,167,510,5,0.3268101761252446,677,112.83333333333333,0
1,3,651,56,23,11.421052631578947,707,29.458333333333332,0
2,3,771,694,83,1.1093525179856114,1465,17.44047619047619,0
0,0,677,332,69,2.033033033033033,1009,14.414285714285715,0
1,0,1621,87,1,18.420454545454547,1708,854.0,1
0,0,1109,162,14,6.803680981595092,1271,84.73333333333333,0
1,2,135,339,9,0.39705882352941174,474,47.4,0
2,1,425,1313,19,0.3234398782343988,1738,86.9,0
2,1,414,152,53,2.7058823529411766,566,10.481481481481481,0
0,1,833,92,40,8.956989247311828,925,22.5609756097561,0
1,2,344,580,12,0.5920826161790017,924,71.07692307692308,0
0,1,124,654,14,0.18931297709923664,778,51.86666666666667,0
0,2,1060,75,31,13.947368421052632,1135,35.46875,0
1,1,1904,267,6,7.104477611940299,2171,310.14285714285717,1
1,0,2682,243,3,10.991803278688524,2925,731.25,0
1,3,3596,164,8,21.793939393939393,3760,417.77777777777777,0
2,3,1519,303,3,4.996710526315789,1822,455.5,1
0,2,150,30,13,4.838709677419355,180,12.857142857142858,1
0,1,1918,843,83,2.272511848341232,2761,32.86904761904762,0
2,3,510,3571,3,0.1427771556550952,4081,1020.25,0
1,0,1309,804,51,1.626086956521739,2113,40.63461538461539,0
2,0,757,358,22,2.1086350974930363,1115,48.47826086956522,0
2,0,1763,881,30,1.9988662131519275,2644,85.29032258064517,0
2,2,554,678,5,0.8159057437407953,1232,205.33333333333334,0
0,2,63,1500,4,0.04197201865423051,1563,312.6,0
2,1,813,778,5,1.0436456996148908,1591,265.1666666666667,0
0,0,187,804,32,0.23229813664596274,991,30.03030303030303,0
0,1,3367,200,41,16.751243781094526,3567,84.92857142857143,0
0,1,748,429,75,1.7395348837209301,1177,15.486842105263158,0
1,0,806,337,15,2.3846153846153846,1143,71.4375,0
0,1,2378,9,18,237.8,2387,125.63157894736842,0
0,3,979,300,19,3.2524916943521593,1279,63.95,0
1,2,360,532,9,0.6754221388367729,892,89.2,0
0,1,351,732,11,0.47885402455661663,1083,90.25,0
2,0,696,2181,56,0.31897341888175984,2877,50.473684210526315,0
2,2,2014,218,12,9.19634703196347,2232,171.69230769230768,0
0,2,1583,132,60,11.902255639097744,1715,28.114754098360656,0
1,1,3289,1628,10,2.0190300798035605,4917,447.0,0
2,3,74,2275,12,0.03251318101933216,2349,180.69230769230768,0
1,1,312,535,24,0.582089552238806,847,33.88,0
1,3,83,97,3,0.8469387755102041,180,45.0,0
2,2,1390,531,76,2.612781954887218,1921,24.948051948051948,0
1,1,151,92,51,1.6236559139784945,243,4.673076923076923,0
2,0,105,1717,33,0.06111757857974389,1822,53.588235294117645,0
1,1,824,985,132,0.8356997971602435,1809,13.601503759398497,0
2,3,530,220,0,2.3981900452488687,750,750.0,0
0,3,1255,1742,15,0.7200229489386116,2997,187.3125,0
2,1,667,812,58,0.8204182041820418,1479,25.06779661016949,0
2,3,553,2450,17,0.22562219502243983,3003,166.83333333333334,0
2,2,554,3149,0,0.17587301587301588,3703,3703.0,0
2,1,2054,2,5,684.6666666666666,2056,342.6666666666667,1
1,3,502,102,17,4.87378640776699,604,33.55555555555556,0
0,1,405,633,33,0.638801261829653,1038,30.529411764705884,0
2,1,413,2496,5,0.16539847817380857,2909,484.8333333333333,0
1,0,218,4124,17,0.052848484848484846,4342,241.22222222222223,0
0,1,1971,670,0,2.9374068554396424,2641,2641.0,0
0,0,158,152,19,1.0326797385620916,310,15.5,0
0,3,2392,142,67,16.727272727272727,2534,37.26470588235294,1
0,0,333,1154,27,0.2883116883116883,1487,53.107142857142854,0
2,0,2296,717,17,3.1977715877437327,3013,167.38888888888889,0
2,0,1564,636,5,2.455259026687598,2200,366.6666666666667,0
1,2,872,501,6,1.7370517928286853,1373,196.14285714285714,0
1,0,1107,1033,2,1.0705996131528046,2140,713.3333333333334,0
1,1,394,1561,40,0.25224071702944945,1955,47.68292682926829,0
0,0,853,288,2,2.9515570934256057,1141,380.3333333333333,0
0,1,345,199,14,1.725,544,36.266666666666666,0
2,0,514,887,41,0.5788288288288288,1401,33.357142857142854,0
0,2,1446,1969,37,0.7340101522842639,3415,89.86842105263158,0
0,3,279,342,25,0.8134110787172012,621,23.884615384615383,0
0,0,1825,254,25,7.1568627450980395,2079,79.96153846153847,0
1,0,471,205,2,2.2864077669902914,676,225.33333333333334,0
1,2,759,234,5,3.2297872340425533,993,165.5,1
2,0,2846,115,22,24.53448275862069,2961,128.7391304347826,0
0,1,1143,726,12,1.5722145804676755,1869,143.76923076923077,0
0,0,1037,263,0,3.928030303030303,1300,1300.0,1
2,0,1243,763,48,1.6269633507853403,2006,40.93877551020408,0
0,3,2502,69,31,35.74285714285714,2571,80.34375,1
0,3,285,98,11,2.878787878787879,383,31.916666666666668,0
1,0,949,614,3,1.5430894308943088,1563,390.75,0
2,2,511,573,26,0.8902439024390244,1084,40.148148148148145,0
2,3,11,253,12,0.04330708661417323,264,20.307692307692307,0
2,0,133,1404,8,0.09466192170818505,1537,170.77777777777777,0
2,3,393,165,38,2.3674698795180724,558,14.307692307692308,0
1,0,832,357,11,2.3240223463687153,1189,99.08333333333333,0
1,3,2132,648,4,3.285053929121726,2780,556.0,0
0,3,1565,1615,19,0.968440594059406,3180,159.0,0
0,1,805,433,52,1.8548387096774193,1238,23.358490566037737,0
0,0,76,406,56,0.18673218673218672,482,8.456140350877194,0
0,0,336,693,56,0.484149855907781,1029,18.05263157894737,0
1,0,456,304,16,1.4950819672131148,760,44.705882352941174,0
2,0,972,988,46,0.9828109201213346,1960,41.702127659574465,0
1,3,67,228,56,0.2925764192139738,295,5.175438596491228,0
0,1,755,1386,18,0.5443403028118241,2141,112.6842105263158,0
1,1,2317,254,11,9.086274509803921,2571,214.25,0
2,2,1222,3936,36,0.31038862077724155,5158,139.40540540540542,0
2,0,1594,304,70,5.226229508196721,1898,26.732394366197184,0
1,2,1144,1688,107,0.6773238602723505,2832,26.22222222222222,0
1,3,231,405,10,0.5689655172413793,636,57.81818181818182,0
1,2,117,225,93,0.5176991150442478,342,3.6382978723404253,0
0,0,1768,205,20,8.58252427184466,1973,93.95238095238095,1
1,1,1189,1518,10,0.78275181040158,2707,246.0909090909091,0
1,1,855,295,133,2.8885135135135136,1150,8.582089552238806,0
1,0,209,330,63,0.6314199395770392,539,8.421875,0
2,3,924,175,35,5.25,1099,30.52777777777778,0
2,0,31,2602,67,0.011909335382251248,2633,38.720588235294116,0
0,3,126,224,34,0.56,350,10.0,0
0,1,373,227,17,1.6359649122807018,600,33.333333333333336,0
2,3,586,2304,88,0.2542299349240781,2890,32.47191011235955,0
2,0,128,1849,99,0.06918918918918919,1977,19.77,0
2,0,127,228,11,0.5545851528384279,355,29.583333333333332,0
1,0,1294,1600,13,0.8082448469706434,2894,206.71428571428572,0
1,3,843,229,14,3.6652173913043478,1072,71.46666666666667,0
2,3,763,70,51,10.746478873239436,833,16.01923076923077,0
1,3,602,1373,46,0.438136826783115,1975,42.02127659574468,0
1,1,3752,1181,122,3.1742808798646363,4933,40.10569105691057,1
0,2,51,279,18,0.18214285714285713,330,17.36842105263158,0
2,2,199,75,40,2.6184210526315788,274,6.682926829268292,0
2,0,1042,184,58,5.632432432432433,1226,20.779661016949152,0
1,1,146,1179,7,0.12372881355932204,1325,165.625,0
2,3,890,2676,29,0.3324617108703773,3566,118.86666666666666,0
0,0,838,239,23,3.4916666666666667,1077,44.875,0
0,1,3540,1364,40,2.5934065934065935,4904,119.60975609756098,1
0,0,2148,206,35,10.376811594202898,2354,65.38888888888889,0
2,1,2910,910,50,3.194291986827662,3820,74.90196078431373,0
2,1,120,69,11,1.7142857142857142,189,15.75,0
2,2,2026,704,7,2.873758865248227,2730,341.25,0
2,0,138,250,49,0.549800796812749,388,7.76,0
2,3,1002,2081,13,0.4812680115273775,3083,220.21428571428572,0
0,2,1273,273,10,4.645985401459854,1546,140.54545454545453,0
1,2,175,406,12,0.42997542997543,581,44.69230769230769,0
0,3,1001,1469,2,0.680952380952381,2470,823.3333333333334,0
2,1,53,461,44,0.11471861471861472,514,11.422222222222222,0
0,3,347,217,37,1.591743119266055,564,14.842105263157896,0
2,0,2540,634,24,4.0,3174,126.96,0
2,3,188,1466,37,0.1281526925698705,1654,43.526315789473685,0
0,1,67,454,14,0.14725274725274726,521,34.733333333333334,0
2,3,586,114,10,5.095652173913043,700,63.63636363636363,1
1,1,1901,386,59,4.912144702842378,2287,38.11666666666667,0
2,1,79,2471,16,0.031957928802589,2550,150.0,0
1,0,439,59,6,7.316666666666666,498,71.14285714285714,0
1,3,2300,420,41,5.463182897862233,2720,64.76190476190476,0
2,3,125,835,12,0.14952153110047847,960,73.84615384615384,0
0,0,372,65,7,5.636363636363637,437,54.625,1
1,1,1506,338,0,4.442477876106195,1844,1844.0,0
0,3,783,2258,105,0.3466135458167331,3041,28.68867924528302,0
1,0,1785,24,18,71.4,1809,95.21052631578948,0
2,1,118,1114,5,0.10582959641255606,1232,205.33333333333334,0
2,0,2532,1472,42,1.7189409368635438,4004,93.11627906976744,0
1,3,2732,259,65,10.507692307692308,2991,45.31818181818182,0
2,0,168,193,22,0.865979381443299,361,15.695652173913043,0
1,2,34,1970,0,0.017250126839167934,2004,2004.0,0
2,1,4589,1155,13,3.9697231833910034,5744,410.2857142857143,0
0,2,658,96,8,6.783505154639175,754,83.77777777777777,1
2,2,848,190,30,4.439790575916231,1038,33.483870967741936,1
0,1,956,776,21,1.2303732303732304,1732,78.72727272727273,0
2,1,1559,434,13,3.5839080459770116,1993,142.35714285714286,1
0,0,1671,561,31,2.973309608540925,2232,69.75,0
2,1,215,2421,26,0.08876961189099918,2636,97.62962962962963,0
0,2,270,436,71,0.6178489702517163,706,9.805555555555555,0
1,2,2094,1707,27,1.2259953161592505,3801,135.75,0
1,3,1712,864,21,1.9791907514450866,2576,117.0909090909091,0
0,1,961,103,52,9.240384615384615,1064,20.07547169811321,1
2,2,5239,1091,6,4.7976190476190474,6330,904.2857142857143,0
0,3,1328,587,8,2.258503401360544,1915,212.77777777777777,0
2,3,243,204,45,1.1853658536585365,447,9.717391304347826,0
1,0,1874,273,17,6.839416058394161,2147,119.27777777777777,0
2,2,535,651,15,0.8205521472392638,1186,74.125,0
1,0,36,736,65,0.048846675712347354,772,11.696969696969697,0
2,2,387,2758,28,0.1402682131206959,3145,108.44827586206897,0
2,0,1442,1543,48,0.9339378238341969,2985,60.91836734693877,0
2,0,3224,184,49,17.427027027027027,3408,68.16,0
0,1,323,1189,3,0.2714285714285714,1512,378.0,0
0,0,283,6,31,40.42857142857143,289,9.03125,0
1,1,829,111,91,7.401785714285714,940,10.217391304347826,1
1,3,1669,178,19,9.324022346368714,1847,92.35,0
0,2,1372,727,39,1.8846153846153846,2099,52.475,0
1,3,820,173,25,4.712643678160919,993,38.19230769230769,0
0,2,998,363,6,2.741758241758242,1361,194.42857142857142,0
2,3,277,222,6,1.242152466367713,499,71.28571428571429,0
1,2,566,329,17,1.715151515151515,895,49.72222222222222,0
1,0,294,2284,19,0.12866520787746172,2578,128.9,0
0,2,2157,4754,20,0.45362776025236595,6911,329.0952380952381,1
1,2,119,925,93,0.1285097192224622,1044,11.106382978723405,0
1,3,1138,679,3,1.673529411764706,1817,454.25,0
2,3,301,986,14,0.3049645390070922,1287,85.8,0
1,3,645,1181,21,0.5456852791878173,1826,83.0,0
2,1,355,1074,98,0.3302325581395349,1429,14.434343434343434,0
0,1,390,68,21,5.6521739130434785,458,20.818181818181817,0
1,2,301,297,44,1.0100671140939597,598,13.28888888888889,0
2,2,1397,336,41,4.14540059347181,1733,41.26190476190476,0
0,0,455,368,25,1.2330623306233062,823,31.653846153846153,0
1,0,1295,337,4,3.831360946745562,1632,326.4,1
0,2,608,1237,7,0.4911147011308562,1845,230.625,0
1,1,792,1101,8,0.7186932849364791,1893,210.33333333333334,0
0,2,783,3,1,195.75,786,393.0,1
0,0,3723,281,14,13.202127659574469,4004,266.93333333333334,0
2,1,457,781,28,0.5843989769820972,1238,42.689655172413794,0
0,1,232,102,4,2.2524271844660193,334,66.8,0
1,0,2428,59,5,40.46666666666667,2487,414.5,1
1,2,192,1410,36,0.13607370659107015,1602,43.2972972972973,0
2,3,1798,482,5,3.722567287784679,2280,380.0,0
1,2,162,1548,4,0.10458360232408005,1710,342.0,0
1,2,1075,1387,114,0.7744956772334294,2462,21.408695652173915,0
1,0,163,1790,0,0.0910106085985483,1953,1953.0,0
0,1,2565,39,11,64.125,2604,217.0,0
0,0,832,164,1,5.042424242424242,996,498.0,0
1,2,399,280,54,1.4199288256227758,679,12.345454545454546,0
2,3,151,117,26,1.2796610169491525,268,9.925925925925926,0
0,3,463,531,1,0.8703007518796992,994,497.0,0
2,3,1220,1283,28,0.9501557632398754,2503,86.3103448275862,0
1,0,486,2415,3,0.201158940397351,2901,725.25,0
1,1,282,1762,20,0.15995462280204198,2044,97.33333333333333,0
0,0,861,489,33,1.7571428571428571,1350,39.705882352941174,0
1,3,540,809,4,0.6666666666666666,1349,269.8,0
0,2,181,209,20,0.861904761904762,390,18.571428571428573,0
1,1,167,412,18,0.4043583535108959,579,30.473684210526315,0
1,0,1229,1639,74,0.749390243902439,2868,38.24,0
0,0,3675,23,163,153.125,3698,22.548780487804876,0
0,1,265,608,31,0.4351395730706076,873,27.28125,0
0,1,1483,1649,57,0.8987878787878788,3132,54.0,0
1,2,91,104,31,0.8666666666666667,195,6.09375,0
1,1,480,3238,62,0.14819388700216116,3718,59.01587301587302,0
2,2,706,9,17,70.6,715,39.72222222222222,0
0,3,312,1738,28,0.1794134560092007,2050,70.6896551724138,0
1,3,754,349,55,2.1542857142857144,1103,19.696428571428573,0
1,0,2142,113,75,18.789473684210527,2255,29.67105263157895,0
0,3,2890,136,0,21.094890510948904,3026,3026.0,1
2,3,105,966,3,0.10858324715615306,1071,267.75,0
0,2,317,1636,80,0.19364691508857668,1953,24.11111111111111,0
2,0,3869,819,25,4.71829268292683,4688,180.30769230769232,1
1,1,315,2112,138,0.14907714150496923,2427,17.46043165467626,0
2,0,1179,1478,47,0.7971602434077079,2657,55.354166666666664,0
1,3,292,7,51,36.5,299,5.75,0
0,1,440,885,14,0.4966139954853273,1325,88.33333333333333,0
0,0,212,290,8,0.7285223367697594,502,55.77777777777778,0
0,0,1940,484,27,4.0,2424,86.57142857142857,0
2,0,2142,78,63,27.11392405063291,2220,34.6875,0
1,0,352,265,38,1.3233082706766917,617,15.820512820512821,0
0,2,1734,801,19,2.162094763092269,2535,126.75,0
0,0,443,197,41,2.2373737373737375,640,15.238095238095237,0
1,3,104,834,35,0.12455089820359282,938,26.055555555555557,0
0,3,1419,2051,73,0.6915204678362573,3470,46.891891891891895,0
1,2,907,3,9,226.75,910,91.0,0
1,1,320,1232,3,0.259529602595296,1552,388.0,0
1,1,291,820,19,0.35444579780755175,1111,55.55,0
1,3,3714,38,13,95.23076923076923,3752,268.0,0
1,3,1984,1249,110,1.5872,3233,29.126126126126128,0
2,2,1659,203,0,8.132352941176471,1862,1862.0,1
0,1,136,247,81,0.5483870967741935,383,4.670731707317073,0
2,1,1407,78,93,17.810126582278482,1485,15.797872340425531,0
0,0,241,611,1,0.3937908496732026,852,426.0,0
2,0,3789,551,66,6.864130434782608,4340,64.77611940298507,0
1,0,53,341,19,0.15497076023391812,394,19.7,0
0,2,434,147,43,2.9324324324324325,581,13.204545454545455,0
0,3,559,1455,2,0.38392857142857145,2014,671.3333333333334,0
2,2,1738,1672,93,1.0388523610280933,3410,36.276595744680854,0
2,1,1453,622,28,2.332263242375602,2075,71.55172413793103,0
0,3,469,224,68,2.0844444444444443,693,10.043478260869565,0
2,0,833,80,33,10.283950617283951,913,26.852941176470587,0
2,2,1805,1623,23,1.1114532019704433,3428,142.83333333333334,0
2,2,18,80,5,0.2222222222222222,98,16.333333333333332,0
1,0,1620,10,5,147.27272727272728,1630,271.6666666666667,0
1,2,2935,506,19,5.788954635108481,3441,172.05,1
2,0,32,1051,61,0.030418250950570342,1083,17.467741935483872,0
2,1,46,489,3,0.09387755102040816,535,133.75,0
1,3,422,42,192,9.813953488372093,464,2.4041450777202074,0
1,1,91,937,62,0.09701492537313433,1028,16.317460317460316,0
0,1,652,822,14,0.7922235722964763,1474,98.26666666666667,0
0,0,1304,915,8,1.4235807860262009,2219,246.55555555555554,0
1,2,836,189,76,4.4,1025,13.311688311688311,0
2,1,218,1270,3,0.17151848937844216,1488,372.0,0
2,1,1063,521,12,2.0363984674329503,1584,121.84615384615384,0
2,1,1154,614,2,1.8764227642276423,1768,589.3333333333334,0
2,2,2694,631,92,4.262658227848101,3325,35.75268817204301,0
0,2,158,270,28,0.5830258302583026,428,14.758620689655173,0
1,0,1178,230,12,5.0995670995671,1408,108.3076923076923,0
2,1,2423,3,9,605.75,2426,242.6,0
0,3,696,404,17,1.7185185185185186,1100,61.111111111111114,0
2,2,449,531,2,0.8439849624060151,980,326.6666666666667,0
1,0,187,1086,66,0.17203311867525298,1273,19.0,0
0,1,2015,55,21,35.982142857142854,2070,94.0909090909091,0
1,3,501,2061,38,0.24296799224054316,2562,65.6923076923077,0
1,2,2588,245,7,10.520325203252032,2833,354.125,0
0,3,1882,365,21,5.14207650273224,2247,102.13636363636364,0
0,2,472,39,7,11.8,511,63.875,0
0,0,853,847,50,1.0058962264150944,1700,33.333333333333336,0
0,3,27,987,44,0.027327935222672066,1014,22.533333333333335,0
0,1,305,2113,4,0.14427625354777673,2418,483.6,0
0,1,1238,328,2,3.762917933130699,1566,522.0,0
0,2,1132,238,52,4.7364016736401675,1370,25.849056603773583,1
2,1,435,1035,3,0.4198841698841699,1470,367.5,0
1,3,1653,981,23,1.6832993890020367,2634,109.75,0
0,0,268,2213,22,0.12104787714543812,2481,107.8695652173913,0
2,2,618,183,6,3.358695652173913,801,114.42857142857143,0
2,3,639,977,26,0.6533742331288344,1616,59.851851851851855,0
2,2,416,55,20,7.428571428571429,471,22.428571428571427,0
1,0,3093,523,21,5.902671755725191,3616,164.36363636363637,1
0,2,1192,101,13,11.686274509803921,1293,92.35714285714286,1
2,1,774,847,54,0.9127358490566038,1621,29.472727272727273,0
1,1,714,735,2,0.970108695652174,1449,483.0,0
1,2,173,40,17,4.219512195121951,213,11.833333333333334,0
1,0,465,308,9,1.5048543689320388,773,77.3,0
2,0,1117,402,56,2.771712158808933,1519,26.649122807017545,0
0,1,2584,228,7,11.283842794759826,2812,351.5,0
2,0,1695,31,43,52.96875,1726,39.22727272727273,0
2,2,357,307,28,1.1590909090909092,664,22.896551724137932,0
0,3,569,1258,62,0.45194598888006354,1827,29.0,0
0,2,86,357,27,0.24022346368715083,443,15.821428571428571,0
0,1,107,312,24,0.34185303514376997,419,16.76,0
1,1,635,2274,48,0.27912087912087913,2909,59.36734693877551,0
0,1,755,34,24,21.571428571428573,789,31.56,1
2,0,306,1166,55,0.2622107969151671,1472,26.285714285714285,0
0,2,1029,527,1,1.9488636363636365,1556,778.0,0
2,3,1215,2312,20,0.5252918287937743,3527,167.95238095238096,0
1,2,355,400,50,0.885286783042394,755,14.803921568627452,0
2,3,1420,984,56,1.4416243654822336,2404,42.175438596491226,0
2,2,230,58,53,3.8983050847457625,288,5.333333333333333,1
0,1,785,2113,27,0.37133396404919583,2898,103.5,0
0,3,1631,337,153,4.825443786982248,1968,12.779220779220779,0
2,2,770,593,6,1.2962962962962963,1363,194.71428571428572,0
0,0,2385,119,5,19.875,2504,417.3333333333333,1
1,0,60,2328,1,0.025762129669386003,2388,1194.0,0
1,2,887,894,136,0.9910614525139665,1781,13.0,0
0,1,824,44,12,18.31111111111111,868,66.76923076923077,1
1,3,1079,134,43,7.992592592592593,1213,27.568181818181817,0
0,2,1792,408,1,4.381418092909535,2200,1100.0,1
2,0,1294,195,10,6.6020408163265305,1489,135.36363636363637,0
2,3,1561,290,29,5.364261168384879,1851,61.7,0
1,0,340,4790,22,0.0709663953245669,5130,223.04347826086956,1
0,0,490,859,6,0.5697674418604651,1349,192.71428571428572,0
0,2,985,2043,18,0.48189823874755383,3028,159.3684210526316,0
1,0,806,457,3,1.759825327510917,1263,315.75,0
2,3,3246,991,23,3.2721774193548385,4237,176.54166666666666,0
1,1,206,492,3,0.4178498985801217,698,174.5,0
2,2,432,318,30,1.35423197492163,750,24.193548387096776,0
0,3,850,585,5,1.4505119453924915,1435,239.16666666666666,0
2,2,2024,445,23,4.538116591928251,2469,102.875,0
1,0,2649,3151,4,0.8404187817258884,5800,1160.0,1
0,0,409,548,15,0.7449908925318761,957,59.8125,0
1,3,69,1333,13,0.05172413793103448,1402,100.14285714285714,0
1,3,547,879,42,0.6215909090909091,1426,33.16279069767442,0
2,1,501,522,30,0.9579349904397706,1023,33.0,0
1,3,4304,514,82,8.357281553398058,4818,58.04819277108434,1
2,3,563,334,76,1.680597014925373,897,11.64935064935065,0
0,2,364,90,38,4.0,454,11.64102564102564,0
2,0,454,1146,44,0.3958151700087184,1600,35.55555555555556,0
0,3,505,2001,29,0.25224775224775225,2506,83.53333333333333,0
2,1,1723,196,35,8.746192893401016,1919,53.30555555555556,1
1,3,84,2079,28,0.04038461538461539,2163,74.58620689655173,0
2,0,380,211,11,1.7924528301886793,591,49.25,0
2,3,3390,604,12,5.603305785123967,3994,307.2307692307692,0
0,2,166,336,25,0.49258160237388726,502,19.307692307692307,0
1,0,1357,97,38,13.846938775510203,1454,37.282051282051285,0
2,3,440,43,15,10.0,483,30.1875,1
1,2,871,363,4,2.392857142857143,1234,246.8,0
2,0,104,38,18,2.6666666666666665,142,7.473684210526316,0
2,3,365,88,99,4.101123595505618,453,4.53,0
1,2,694,122,7,5.642276422764228,816,102.0,0
2,1,263,1,31,131.5,264,8.25,0
1,2,780,133,121,5.82089552238806,913,7.483606557377049,0
2,1,248,688,14,0.3599419448476052,936,62.4,0
0,3,1050,1369,65,0.7664233576642335,2419,36.65151515151515,0
1,2,2347,171,59,13.645348837209303,2518,41.96666666666667,0
2,1,89,67,12,1.3088235294117647,156,12.0,0
2,0,244,1046,3,0.23304680038204392,1290,322.5,0
0,2,1860,6,5,265.7142857142857,1866,311.0,0
1,3,998,1059,13,0.9415094339622642,2057,146.92857142857142,0
2,0,81,112,95,0.7168141592920354,193,2.0104166666666665,0
0,1,666,207,9,3.201923076923077,873,87.3,0
2,2,235,102,78,2.2815533980582523,337,4.265822784810126,0
1,2,222,227,6,0.9736842105263158,449,64.14285714285714,0
2,3,2824,1280,105,2.204527712724434,4104,38.716981132075475,0
2,0,1433,113,10,12.570175438596491,1546,140.54545454545453,1
2,2,1191,4115,30,0.2893586005830904,5306,171.16129032258064,0
2,2,273,316,2,0.861198738170347,589,196.33333333333334,0
0,0,126,2040,10,0.061734443900048994,2166,196.9090909090909,0
0,2,2046,168,7,12.106508875739644,2214,276.75,0
1,0,5,166,0,0.029940119760479042,171,171.0,0
0,0,491,666,5,0.7361319340329835,1157,192.83333333333334,0
0,0,325,41,26,7.738095238095238,366,13.555555555555555,1
1,3,844,1291,14,0.653250773993808,2135,142.33333333333334,0
0,0,288,463,38,0.6206896551724138,751,19.256410256410255,0
0,0,372,961,33,0.3866943866943867,1333,39.205882352941174,0
1,1,1897,153,48,12.318181818181818,2050,41.83673469387755,0
1,1,924,822,60,1.1227217496962334,1746,28.62295081967213,0
1,3,157,721,51,0.21745152354570638,878,16.884615384615383,0
2,0,1296,1127,17,1.148936170212766,2423,134.61111111111111,0
2,1,232,282,11,0.8197879858657244,514,42.833333333333336,0
1,1,567,2164,20,0.26189376443418017,2731,130.04761904761904,0
1,2,1040,2601,22,0.3996925441967717,3641,158.30434782608697,0
1,0,317,1620,11,0.19555829734731647,1937,161.41666666666666,0
2,1,484,678,23,0.7128129602356407,1162,48.416666666666664,0
2,3,1324,436,3,3.0297482837528604,1760,440.0,0
0,2,2779,47,7,57.895833333333336,2826,353.25,0
0,2,753,2353,41,0.31988105352591334,3106,73.95238095238095,0
1,0,10,2425,6,0.004122011541632316,2435,347.85714285714283,0
2,0,413,15,4,25.8125,428,85.6,0
2,2,508,353,10,1.4350282485875707,861,78.27272727272727,0
2,3,414,1696,13,0.24395992928697702,2110,150.71428571428572,0
1,0,573,67,11,8.426470588235293,640,53.333333333333336,1
0,0,1001,175,14,5.6875,1176,78.4,1
1,2,129,3078,4,0.04189671971419292,3207,641.4,0
0,2,318,1503,5,0.21143617021276595,1821,303.5,0
0,0,708,1944,8,0.3640102827763496,2652,294.6666666666667,0
1,1,379,122,15,3.0813008130081303,501,31.3125,0
0,0,4720,189,12,24.842105263157894,4909,377.61538461538464,1
0,1,564,743,47,0.7580645161290323,1307,27.229166666666668,0
2,2,2038,557,22,3.652329749103943,2595,112.82608695652173,1
0,1,2268,283,25,7.985915492957746,2551,98.11538461538461,0
1,3,1807,1722,24,1.048752176436448,3529,141.16,0
1,2,48,1853,15,0.025889967637540454,1901,118.8125,0
0,0,2951,275,118,10.692028985507246,3226,27.10924369747899,0
2,0,137,135,1,1.0073529411764706,272,136.0,0
2,2,35,129,7,0.2692307692307692,164,20.5,0
0,2,535,529,10,1.009433962264151,1064,96.72727272727273,0
0,3,216,114,63,1.8782608695652174,330,5.15625,0
1,2,203,512,75,0.39571150097465885,715,9.407894736842104,0
0,0,339,495,56,0.6834677419354839,834,14.631578947368421,0
2,3,285,1724,16,0.16521739130434782,2009,118.17647058823529,0
0,0,1154,281,73,4.092198581560283,1435,19.39189189189189,0
1,1,206,657,3,0.3130699088145897,863,215.75,0
1,2,783,1088,31,0.71900826446281,1871,58.46875,0
1,1,4299,724,83,5.929655172413793,5023,59.79761904761905,0
1,0,566,2464,42,0.22961460446247464,3030,70.46511627906976,0
1,1,1026,737,9,1.3902439024390243,1763,176.3,0
0,1,3485,1857,37,1.8756727664155006,5342,140.57894736842104,1
0,0,148,224,10,0.6577777777777778,372,33.81818181818182,0
0,0,542,658,3,0.8224582701062215,1200,300.0,0
0,2,1898,626,37,3.0271132376395533,2524,66.42105263157895,0
1,1,2692,3641,5,0.7391543108182317,6333,1055.5,0
2,3,919,183,3,4.994565217391305,1102,275.5,0
0,3,154,121,24,1.2622950819672132,275,11.0,0
2,0,2317,756,29,3.060766182298547,3073,102.43333333333334,0
0,0,191,202,1,0.9408866995073891,393,196.5,0
0,1,435,815,0,0.5330882352941176,1250,1250.0,0
2,0,470,2874,64,0.1634782608695652,3344,51.44615384615385,0
1,3,592,2342,3,0.2526675202731541,2934,733.5,0
0,2,1561,210,26,7.398104265402844,1771,65.5925925925926,1
0,2,1620,149,92,10.8,1769,19.021505376344088,1
0,1,1271,658,21,1.9286798179059181,1929,87.68181818181819,0
2,2,22,707,4,0.031073446327683617,729,145.8,0
1,0,832,868,15,0.9574223245109321,1700,106.25,0
2,0,1376,1082,29,1.270544783010157,2458,81.93333333333334,0
2,0,588,734,43,0.8,1322,30.045454545454547,0
1,0,2899,94,28,30.51578947368421,2993,103.20689655172414,1
2,1,1736,1249,1,1.3888,2985,1492.5,0
1,2,1016,66,4,15.164179104477611,1082,216.4,0
0,3,64,16,13,3.764705882352941,80,5.714285714285714,0
1,2,1056,1174,36,0.8987234042553192,2230,60.270270270270274,0
0,0,2425,635,26,3.8128930817610063,3060,113.33333333333333,1
2,3,477,959,1,0.496875,1436,718.0,0
2,1,1820,385,47,4.715025906735751,2205,45.9375,1
0,0,375,8,27,41.666666666666664,383,13.678571428571429,1
2,0,844,321,65,2.62111801242236,1165,17.651515151515152,0
1,3,1045,749,16,1.3933333333333333,1794,105.52941176470588,0
0,1,1133,204,20,5.5268292682926825,1337,63.666666666666664,0
2,3,2141,931,15,2.2972103004291844,3072,192.0,0
0,1,267,1265,38,0.2109004739336493,1532,39.282051282051285,0
1,0,304,484,41,0.6268041237113402,788,18.761904761904763,0
1,2,1217,1668,38,0.7291791491911325,2885,73.97435897435898,0
2,0,195,1543,10,0.12629533678756477,1738,158.0,0
1,2,624,1683,30,0.37054631828978624,2307,74.41935483870968,0
0,2,20,865,12,0.023094688221709007,885,68.07692307692308,0
1,1,151,290,53,0.5189003436426117,441,8.166666666666666,0
0,3,1135,525,1,2.1577946768060836,1660,830.0,0
0,1,1376,991,1,1.3870967741935485,2367,1183.5,0
1,0,122,189,3,0.6421052631578947,311,77.75,0
2,3,258,1074,6,0.24,1332,190.28571428571428,0
1,2,104,635,1,0.16352201257861634,739,369.5,0
0,2,568,80,2,7.012345679012346,648,216.0,1
0,0,134,651,10,0.20552147239263804,785,71.36363636363636,0
1,3,575,55,3,10.267857142857142,630,157.5,1
2,0,1317,11,48,109.75,1328,27.102040816326532,0
2,0,1150,1763,1,0.6519274376417233,2913,1456.5,0
0,1,329,538,71,0.6103896103896104,867,12.041666666666666,0
0,0,1120,626,61,1.7862838915470494,1746,28.161290322580644,0
2,3,2627,262,7,9.988593155893536,2889,361.125,0
1,0,426,626,2,0.6794258373205742,1052,350.6666666666667,0
0,3,399,147,3,2.695945945945946,546,136.5,0
0,2,847,1095,24,0.7728102189781022,1942,77.68,0
2,0,281,1386,27,0.20259552992069213,1667,59.535714285714285,0
1,3,1054,1549,11,0.68,2603,216.91666666666666,0
2,2,1785,90,10,19.615384615384617,1875,170.45454545454547,0
1,3,614,652,22,0.9402756508422665,1266,55.04347826086956,0
1,2,1137,1323,10,0.8587613293051359,2460,223.63636363636363,0
1,1,1055,109,81,9.590909090909092,1164,14.195121951219512,0
0,0,39,83,14,0.4642857142857143,122,8.133333333333333,0
2,0,202,1358,7,0.14863870493009565,1560,195.0,0
2,2,2239,1274,4,1.756078431372549,3513,702.6,0
1,1,2795,476,29,5.859538784067086,3271,109.03333333333333,1
0,3,1516,92,11,16.301075268817204,1608,134.0,0
0,1,2541,580,6,4.373493975903615,3121,445.85714285714283,0
2,3,365,401,9,0.9079601990049752,766,76.6,0
0,3,284,584,11,0.48547008547008547,868,72.33333333333333,0
0,0,484,463,29,1.043103448275862,947,31.566666666666666,0
1,2,56,672,5,0.08320950965824665,728,121.33333333333333,0
0,0,1660,1039,39,1.5961538461538463,2699,67.475,0
1,0,4146,1192,10,3.4752724224643754,5338,485.27272727272725,1
2,0,1737,837,20,2.0727923627684963,2574,122.57142857142857,0
0,3,809,177,31,4.544943820224719,986,30.8125,1
2,0,349,404,23,0.8617283950617284,753,31.375,0
2,3,220,59,32,3.6666666666666665,279,8.454545454545455,0
0,2,452,480,11,0.9397089397089398,932,77.66666666666667,0
0,3,1099,2814,99,0.39040852575488455,3913,39.13,0
2,3,592,821,18,0.7201946472019465,1413,74.36842105263158,0
0,1,2719,134,11,20.14074074074074,2853,237.75,1
1,0,1925,250,10,7.669322709163347,2175,197.72727272727272,0
1,0,108,53,1,2.0,161,80.5,0
0,0,141,161,34,0.8703703703703703,302,8.628571428571428,0
2,0,1127,535,9,2.1026119402985075,1662,166.2,0
0,1,262,338,95,0.7728613569321534,600,6.25,0
0,1,1565,182,7,8.551912568306012,1747,218.375,0
2,1,894,126,22,7.039370078740157,1020,44.34782608695652,1
2,1,261,853,39,0.30562060889929743,1114,27.85,0
1,0,651,653,61,0.9954128440366973,1304,21.032258064516128,0
2,3,521,1479,5,0.35202702702702704,2000,333.3333333333333,0
1,2,2064,161,126,12.74074074074074,2225,17.519685039370078,0
2,1,32,1507,71,0.021220159151193633,1539,21.375,0
0,3,2261,690,98,3.272069464544139,2951,29.80808080808081,0
1,1,1055,247,57,4.254032258064516,1302,22.448275862068964,0
1,0,1337,255,63,5.22265625,1592,24.875,0
1,0,2,395,27,0.005050505050505051,397,14.178571428571429,0
0,3,989,493,55,2.0020242914979756,1482,26.464285714285715,0
0,3,887,68,22,12.855072463768115,955,41.52173913043478,0
0,3,770,1476,23,0.5213270142180095,2246,93.58333333333333,0
0,0,1541,103,24,14.817307692307692,1644,65.76,0
0,0,811,528,168,1.5330812854442344,1339,7.923076923076923,0
1,2,1945,386,3,5.025839793281654,2331,582.75,1
0,3,264,574,49,0.4591304347826087,838,16.76,0
1,2,1639,1747,9,0.9376430205949656,3386,338.6,0
0,1,197,3614,13,0.05449515905947441,3811,272.2142857142857,0
2,2,1677,16,2,98.6470588235294,1693,564.3333333333334,0
1,1,2821,399,12,7.0525,3220,247.69230769230768,0
2,1,409,1361,140,0.3002936857562408,1770,12.553191489361701,0
1,2,754,316,15,2.3785488958990535,1070,66.875,0
2,3,1073,837,33,1.2804295942720765,1910,56.1764705882353,0
0,1,82,3889,3,0.021079691516709513,3971,992.75,0
0,3,681,832,76,0.8175270108043218,1513,19.649350649350648,0
0,0,447,94,52,4.705263157894737,541,10.20754716981132,0
1,1,2059,1480,14,1.3902768399729912,3539,235.93333333333334,0
2,0,2092,2720,12,0.768834987137082,4812,370.15384615384613,0
0,2,1206,997,16,1.2084168336673347,2203,129.58823529411765,0
2,3,1066,434,15,2.4505747126436783,1500,93.75,0
2,2,1323,2371,8,0.5577571669477235,3694,410.44444444444446,0
0,1,455,2768,140,0.1643192488262911,3223,22.858156028368793,0
0,0,518,2188,49,0.2366377341251713,2706,54.12,0
2,1,806,424,9,1.8964705882352941,1230,123.0,0
0,2,2781,1247,120,2.2283653846153846,4028,33.289256198347104,0
0,3,1287,849,0,1.5141176470588236,2136,2136.0,1
0,3,800,158,17,5.031446540880503,958,53.22222222222222,1
1,1,1471,613,25,2.3957654723127035,2084,80.15384615384616,0
2,1,463,1101,1,0.42014519056261346,1564,782.0,0
2,0,1311,1810,5,0.7239094422970734,3121,520.1666666666666,0
1,2,528,1587,8,0.33249370277078083,2115,235.0,0
2,1,328,134,38,2.4296296296296296,462,11.846153846153847,0
0,0,940,535,84,1.7537313432835822,1475,17.352941176470587,0
2,1,1161,520,29,2.2284069097888675,1681,56.03333333333333,0
0,3,614,1832,24,0.33496999454446263,2446,97.84,0
1,0,833,1,23,416.5,834,34.75,0
0,0,1184,1073,12,1.1024208566108007,2257,173.6153846153846,0
2,1,1459,771,52,1.8898963730569949,2230,42.075471698113205,0
2,2,2259,2036,23,1.1089837997054492,4295,178.95833333333334,0
2,3,437,488,7,0.8936605316973415,925,115.625,0
1,2,3025,857,4,3.5256410256410255,3882,776.4,0
1,0,1014,2882,127,0.3517169614984391,3896,30.4375,0
2,2,1549,1089,0,1.4211009174311926,2638,2638.0,0
0,0,1203,55,81,21.482142857142858,1258,15.341463414634147,0
1,2,230,146,7,1.564625850340136,376,47.0,0
2,1,74,1378,32,0.05366207396664249,1452,44.0,0
2,2,1295,326,10,3.9602446483180427,1621,147.36363636363637,0
1,0,715,979,58,0.7295918367346939,1694,28.71186440677966,0
1,3,1211,962,23,1.257528556593977,2173,90.54166666666667,0
1,3,647,4053,4,0.15959546127281696,4700,940.0,1
0,3,374,507,9,0.7362204724409449,881,88.1,0
0,0,335,1071,11,0.3125,1406,117.16666666666667,0
2,2,1311,39,65,32.775,1350,20.454545454545453,1
1,3,324,496,43,0.6519114688128773,820,18.636363636363637,0
0,3,1254,165,53,7.554216867469879,1419,26.27777777777778,0
1,3,484,1468,1,0.32947583390061264,1952,976.0,0
2,1,1473,1465,25,1.004774897680764,2938,113.0,0
0,0,154,215,213,0.7129629629629629,369,1.7242990654205608,0
0,0,229,306,46,0.745928338762215,535,11.382978723404255,0
0,0,1158,969,3,1.1938144329896907,2127,531.75,0
2,0,821,1072,34,0.7651444547996272,1893,54.08571428571429,0
1,0,228,857,41,0.26573426573426573,1085,25.833333333333332,0
0,1,2331,4569,21,0.5100656455142232,6900,313.6363636363636,0
2,2,322,1624,2,0.19815384615384615,1946,648.6666666666666,0
1,1,546,431,1,1.2638888888888888,977,488.5,0
2,3,226,316,83,0.7129337539432177,542,6.4523809523809526,0
1,1,491,726,8,0.6753782668500687,1217,135.22222222222223,0
2,0,676,1361,14,0.49632892804698975,2037,135.8,0
1,1,349,516,47,0.6750483558994197,865,18.020833333333332,0
0,0,1465,1070,35,1.3678804855275444,2535,70.41666666666667,0
1,1,500,15,103,31.25,515,4.951923076923077,0
2,0,1307,2081,2,0.6277617675312199,3388,1129.3333333333333,0
2,3,232,1189,36,0.1949579831932773,1421,38.4054054054054,0
1,0,473,400,2,1.1795511221945136,873,291.0,0
0,1,8,387,0,0.020618556701030927,395,395.0,0
0,3,1421,86,3,16.333333333333332,1507,376.75,1
1,1,983,1354,28,0.7254612546125462,2337,80.58620689655173,0
1,3,1702,1170,33,1.453458582408198,2872,84.47058823529412,0
2,2,608,795,17,0.7638190954773869,1403,77.94444444444444,0
0,2,1608,85,1,18.697674418604652,1693,846.5,1
1,2,1042,243,30,4.270491803278689,1285,41.45161290322581,0
0,1,3,491,2,0.006097560975609756,494,164.66666666666666,0
1,1,292,247,4,1.1774193548387097,539,107.8,0
1,3,681,455,21,1.493421052631579,1136,51.63636363636363,0
0,3,964,204,12,4.702439024390244,1168,89.84615384615384,0
1,3,67,344,18,0.19420289855072465,411,21.63157894736842,0
1,3,1221,845,30,1.4432624113475176,2066,66.64516129032258,0
2,0,784,1783,5,0.43946188340807174,2567,427.8333333333333,0
1,2,746,388,67,1.917737789203085,1134,16.676470588235293,0
1,0,345,941,24,0.3662420382165605,1286,51.44,0
1,0,903,115,0,7.7844827586206895,1018,1018.0,0
2,0,27,622,29,0.04333868378812199,649,21.633333333333333,0
0,0,66,2037,18,0.0323846908734053,2103,110.6842105263158,0
2,2,1323,22,36,57.52173913043478,1345,36.351351351351354,0
2,0,388,249,45,1.552,637,13.847826086956522,0
0,3,426,113,83,3.736842105263158,539,6.416666666666667,0
2,1,233,609,192,0.3819672131147541,842,4.362694300518135,0
0,3,589,910,23,0.6465422612513722,1499,62.458333333333336,0
2,1,53,47,24,1.1041666666666667,100,4.0,0
0,3,357,58,0,6.0508474576271185,415,415.0,0
1,3,748,1629,60,0.4588957055214724,2377,38.967213114754095,0
2,1,626,487,0,1.2827868852459017,1113,1113.0,0
2,2,8015,497,30,16.09437751004016,8512,274.5806451612903,0
2,0,492,2314,3,0.2125269978401728,2806,701.5,0
2,3,489,308,10,1.5825242718446602,797,72.45454545454545,0
1,2,700,1818,4,0.38482682792743267,2518,503.6,0
2,0,211,2927,4,0.07206284153005464,3138,627.6,0
1,2,2089,221,2,9.40990990990991,2310,770.0,0
1,2,849,577,11,1.4688581314878892,1426,118.83333333333333,0
1,0,213,611,16,0.3480392156862745,824,48.470588235294116,0
1,3,1577,1608,18,0.9801118707271598,3185,167.6315789473684,0
0,2,34,289,17,0.11724137931034483,323,17.944444444444443,0
0,3,4049,1279,22,3.16328125,5328,231.65217391304347,1
2,3,2003,2832,58,0.7070243558065655,4835,81.94915254237289,1
0,3,866,1467,29,0.5899182561307902,2333,77.76666666666667,0
0,0,117,1918,0,0.060969254820218866,2035,2035.0,0
2,1,242,985,5,0.24543610547667344,1227,204.5,0
2,3,327,1874,12,0.1744,2201,169.30769230769232,0
2,1,275,144,89,1.896551724137931,419,4.655555555555556,0
0,1,688,996,2,0.6900702106318957,1684,561.3333333333334,0
0,2,2892,1053,37,2.7438330170777987,3945,103.8157894736842,0
2,3,587,462,1,1.267818574514039,1049,524.5,0
1,3,1083,66,13,16.16417910447761,1149,82.07142857142857,1
2,3,1166,779,44,1.494871794871795,1945,43.22222222222222,0
1,1,2052,42,12,47.72093023255814,2094,161.07692307692307,0
1,0,34,385,16,0.08808290155440414,419,24.647058823529413,0
2,1,518,400,70,1.2917705735660847,918,12.929577464788732,0
2,3,1535,5466,2,0.2807755624657033,7001,2333.6666666666665,0
2,3,1686,285,22,5.895104895104895,1971,85.69565217391305,0
0,3,2621,1373,13,1.9075691411935953,3994,285.2857142857143,0
1,1,1213,43,99,27.568181818181817,1256,12.56,0
0,3,281,603,47,0.4652317880794702,884,18.416666666666668,0
0,2,704,615,3,1.1428571428571428,1319,329.75,0
2,3,32,792,78,0.0403530895334174,824,10.430379746835444,0
0,0,1041,1328,7,0.7832957110609481,2369,296.125,0
2,2,808,1148,2,0.7032201914708442,1956,652.0,0
1,3,1099,1145,23,0.9589877835951134,2244,93.5,0
2,2,2661,452,40,5.874172185430464,3113,75.92682926829268,1
0,3,1162,1040,37,1.1162343900096061,2202,57.94736842105263,0
0,0,386,540,22,0.7134935304990758,926,40.26086956521739,0
2,3,221,55,20,3.9464285714285716,276,13.142857142857142,0
2,2,1928,1767,104,1.090497737556561,3695,35.19047619047619,0
0,0,216,1767,51,0.12217194570135746,1983,38.13461538461539,0
1,1,176,311,35,0.5641025641025641,487,13.527777777777779,0
1,0,231,1961,6,0.11773700305810397,2192,313.14285714285717,0
2,0,710,1135,51,0.625,1845,35.48076923076923,0
1,0,132,409,41,0.32195121951219513,541,12.880952380952381,0
0,2,2782,322,144,8.613003095975232,3104,21.406896551724138,0
2,0,3388,2955,4,1.1461434370771313,6343,1268.6,0
0,3,3642,997,37,3.649298597194389,4639,122.07894736842105,1
0,0,39,380,116,0.10236220472440945,419,3.5811965811965814,0
1,0,2922,821,18,3.5547445255474455,3743,197.0,0
2,3,5958,678,39,8.774668630338734,6636,165.9,0
2,3,2854,594,111,4.796638655462185,3448,30.785714285714285,1
1,1,1111,827,23,1.3417874396135265,1938,80.75,0
0,0,1208,617,36,1.9546925566343043,1825,49.32432432432432,0
0,2,130,850,0,0.15276145710928318,980,980.0,0
0,0,2073,1905,21,1.0876180482686253,3978,180.8181818181818,0
0,0,61,4000,8,0.015246188452886777,4061,451.22222222222223,0
2,3,382,988,4,0.3862487360970677,1370,274.0,0
2,1,4727,2102,36,2.2477413219210653,6829,184.56756756756758,1
1,0,548,1563,1,0.35038363171355497,2111,1055.5,0
1,2,140,279,70,0.5,419,5.901408450704225,0
2,0,3483,2161,21,1.6110083256244219,5644,256.54545454545456,0
2,2,4143,58,31,70.22033898305085,4201,131.28125,1
0,3,207,320,8,0.6448598130841121,527,58.55555555555556,0
0,1,2001,817,6,2.446210268948655,2818,402.57142857142856,0
1,0,494,598,8,0.8247078464106845,1092,121.33333333333333,0
2,1,480,625,7,0.7667731629392971,1105,138.125,0
1,0,304,1267,59,0.23974763406940064,1571,26.183333333333334,0
2,2,45,173,46,0.25862068965517243,218,4.638297872340425,0
0,1,311,3217,57,0.0966438781852082,3528,60.827586206896555,0
1,0,55,460,39,0.1193058568329718,515,12.875,0
1,3,2581,2394,30,1.0776617954070982,4975,160.48387096774192,0
2,2,1083,386,22,2.798449612403101,1469,63.869565217391305,0
0,1,2177,736,9,2.953867028493894,2913,291.3,0
1,0,1263,478,36,2.636743215031315,1741,47.054054054054056,0
0,1,140,901,4,0.15521064301552107,1041,208.2,0
1,0,2823,162,21,17.319018404907975,2985,135.6818181818182,0
0,2,2301,409,6,5.61219512195122,2710,387.14285714285717,0
2,3,427,56,21,7.491228070175438,483,21.954545454545453,0
1,2,118,729,10,0.16164383561643836,847,77.0,0
1,1,1217,2630,1,0.46256176358798934,3847,1923.5,0
0,1,1303,37,21,34.28947368421053,1340,60.90909090909091,1
0,0,2271,862,6,2.631517960602549,3133,447.57142857142856,0
1,2,54,1193,5,0.04522613065326633,1247,207.83333333333334,0
2,0,152,191,14,0.7916666666666666,343,22.866666666666667,0
0,2,911,255,13,3.55859375,1166,83.28571428571429,0
0,1,965,180,60,5.331491712707182,1145,18.770491803278688,0
0,0,34,282,24,0.12014134275618374,316,12.64,0
1,0,505,93,57,5.372340425531915,598,10.310344827586206,0
1,2,877,370,4,2.3638814016172507,1247,249.4,0
1,3,1339,368,13,3.6287262872628725,1707,121.92857142857143,0
1,2,380,1317,24,0.2883156297420334,1697,67.88,0
2,3,661,1291,4,0.5116099071207431,1952,390.4,0
2,2,1682,1274,4,1.31921568627451,2956,591.2,0
1,1,3076,669,32,4.591044776119403,3745,113.48484848484848,0
2,0,261,315,31,0.8259493670886076,576,18.0,0
0,2,291,423,8,0.6863207547169812,714,79.33333333333333,0
0,1,2810,305,7,9.183006535947712,3115,389.375,0
0,2,504,697,41,0.7220630372492837,1201,28.595238095238095,0
1,0,1267,2224,3,0.569438202247191,3491,872.75,0
0,2,947,267,77,3.533582089552239,1214,15.564102564102564,0
2,3,336,491,86,0.6829268292682927,827,9.505747126436782,0
1,0,1060,851,61,1.244131455399061,1911,30.822580645161292,0
2,3,1065,1489,7,0.714765100671141,2554,319.25,0
0,1,897,233,0,3.8333333333333335,1130,1130.0,0
0,1,104,263,82,0.3939393939393939,367,4.421686746987952,0
0,2,5333,1731,12,3.0790993071593533,7064,543.3846153846154,1
1,3,511,66,11,7.626865671641791,577,48.083333333333336,1
2,3,1016,744,9,1.3637583892617449,1760,176.0,0
1,0,2169,1575,8,1.376269035532995,3744,416.0,0
1,3,550,2038,39,0.2697400686611084,2588,64.7,0
0,3,1486,10,71,135.0909090909091,1496,20.77777777777778,0
1,0,3569,369,46,9.645945945945947,3938,83.7872340425532,0
1,0,444,237,33,1.865546218487395,681,20.029411764705884,0
0,3,519,671,10,0.7723214285714286,1190,108.18181818181819,0
1,2,2359,801,23,2.9413965087281797,3160,131.66666666666666,0
0,0,173,6717,8,0.025751711818993748,6890,765.5555555555555,0
0,0,29,575,3,0.050347222222222224,604,151.0,0
0,3,2395,641,3,3.730529595015576,3036,759.0,0
0,3,1723,427,27,4.025700934579439,2150,76.78571428571429,0
1,0,3596,127,1,28.09375,3723,1861.5,0
0,3,60,289,108,0.20689655172413793,349,3.2018348623853212,0
0,0,169,226,161,0.7444933920704846,395,2.4382716049382718,0
1,2,111,1292,4,0.08584686774941995,1403,280.6,0
1,2,1150,631,16,1.8196202531645569,1781,104.76470588235294,0
2,0,931,281,43,3.301418439716312,1212,27.545454545454547,0
1,0,445,537,93,0.8271375464684015,982,10.446808510638299,0
1,1,59,197,66,0.29797979797979796,256,3.8208955223880596,0
2,1,1020,163,8,6.219512195121951,1183,131.44444444444446,1
1,3,844,1572,2,0.536554354736173,2416,805.3333333333334,0
1,3,119,2317,10,0.05133735979292493,2436,221.45454545454547,0
1,0,2395,66,17,35.74626865671642,2461,136.72222222222223,1
1,0,221,1158,13,0.1906816220880069,1379,98.5,0
2,1,1360,483,44,2.809917355371901,1843,40.955555555555556,0
1,1,2163,394,8,5.4759493670886075,2557,284.1111111111111,0
1,0,866,935,58,0.9252136752136753,1801,30.52542372881356,0
2,2,283,247,7,1.1411290322580645,530,66.25,0
0,2,369,16,13,21.705882352941178,385,27.5,1
2,3,2169,192,17,11.238341968911918,2361,131.16666666666666,0
0,0,354,163,10,2.158536585365854,517,47.0,0
2,0,1371,27,43,48.964285714285715,1398,31.772727272727273,1
2,3,4621,310,15,14.858520900321544,4931,308.1875,1
1,1,8604,514,65,16.706796116504854,9118,138.15151515151516,1
0,1,762,1064,99,0.7154929577464789,1826,18.26,0
1,2,1751,315,58,5.541139240506329,2066,35.016949152542374,0
0,0,4630,173,22,26.60919540229885,4803,208.82608695652175,0
2,1,469,209,21,2.2333333333333334,678,30.818181818181817,0
2,2,290,1774,7,0.16338028169014085,2064,258.0,0
0,2,121,183,26,0.657608695652174,304,11.25925925925926,0
1,2,151,1691,91,0.08924349881796691,1842,20.02173913043478,0
1,1,1921,474,2,4.04421052631579,2395,798.3333333333334,0
1,1,888,2179,41,0.4073394495412844,3067,73.02380952380952,0
1,0,2069,419,61,4.9261904761904765,2488,40.12903225806452,0
2,0,1558,156,129,9.92356687898089,1714,13.184615384615384,0
2,2,1120,637,12,1.755485893416928,1757,135.15384615384616,0
2,2,939,708,13,1.3244005641748942,1647,117.64285714285714,0
2,1,49,807,7,0.06064356435643564,856,107.0,0
2,1,2057,424,46,4.84,2481,52.787234042553195,1
1,0,541,39,4,13.525,580,116.0,1
1,0,820,788,9,1.0392902408111533,1608,160.8,0
1,3,22,2162,10,0.010171058714748035,2184,198.54545454545453,0
1,0,2750,2527,14,1.0878164556962024,5277,351.8,0
2,1,2330,726,16,3.204951856946355,3056,179.76470588235293,0
2,2,783,16,24,46.05882352941177,799,31.96,0
2,3,861,89,88,9.566666666666666,950,10.674157303370787,1
0,0,1220,1436,8,0.848990953375087,2656,295.1111111111111,0
1,0,307,1416,45,0.21665490472829924,1723,37.45652173913044,0
1,1,250,2335,33,0.10702054794520548,2585,76.02941176470588,0
2,3,1120,663,3,1.6867469879518073,1783,445.75,0
1,0,110,1595,49,0.06892230576441102,1705,34.1,0
1,2,605,1393,2,0.4340028694404591,1998,666.0,0
2,1,678,712,40,0.9509116409537167,1390,33.90243902439025,0
0,3,480,1224,37,0.39183673469387753,1704,44.8421052631579,0
0,0,204,107,35,1.8888888888888888,311,8.63888888888889,0
0,0,438,815,9,0.5367647058823529,1253,125.3,0
2,3,411,2453,25,0.16748166259168704,2864,110.15384615384616,0
1,1,691,141,43,4.866197183098592,832,18.90909090909091,0
2,3,1122,1090,30,1.0284142988084326,2212,71.35483870967742,0
2,3,3449,309,48,11.125806451612902,3758,76.6938775510204,0
1,1,155,1359,34,0.11397058823529412,1514,43.25714285714286,0
0,0,2063,955,9,2.157949790794979,3018,301.8,0
0,2,334,2084,4,0.16019184652278176,2418,483.6,0
2,1,894,995,29,0.8975903614457831,1889,62.96666666666667,0
0,2,791,422,42,1.8699763593380614,1213,28.209302325581394,0
2,0,814,8,4,90.44444444444444,822,164.4,0
2,3,1285,1259,5,1.0198412698412698,2544,424.0,0
1,2,480,420,0,1.1401425178147269,900,900.0,0
1,0,384,888,22,0.43194600674915634,1272,55.30434782608695,0
1,0,1916,88,23,21.528089887640448,2004,83.5,0
2,3,248,1772,20,0.13987591652566272,2020,96.19047619047619,0
1,3,198,457,11,0.43231441048034935,655,54.583333333333336,0
0,0,15,2017,16,0.007433102081268583,2032,119.52941176470588,0
0,0,236,982,43,0.24008138351983724,1218,27.681818181818183,0
2,2,730,103,6,7.019230769230769,833,119.0,1
2,0,773,692,6,1.1154401154401155,1465,209.28571428571428,0
1,0,293,1925,32,0.152128764278297,2218,67.21212121212122,0
2,2,75,1287,60,0.05822981366459627,1362,22.327868852459016,0
2,1,1365,433,12,3.1451612903225805,1798,138.30769230769232,0
0,2,1418,2482,80,0.5710833668948853,3900,48.148148148148145,0
0,2,6135,250,1,24.44223107569721,6385,3192.5,1
1,3,2302,376,3,6.106100795755968,2678,669.5,1
2,2,2604,1108,18,2.3480613165013526,3712,195.3684210526316,0
2,0,1600,212,38,7.511737089201878,1812,46.46153846153846,0
0,0,955,579,13,1.646551724137931,1534,109.57142857142857,0
2,0,137,1043,24,0.13122605363984674,1180,47.2,0
0,1,973,826,0,1.1765417170495769,1799,1799.0,0
1,0,57,135,18,0.41911764705882354,192,10.105263157894736,0
0,1,2165,794,8,2.7232704402515724,2959,328.77777777777777,0
2,0,657,680,21,0.9647577092511013,1337,60.77272727272727,0
1,2,1195,652,22,1.8300153139356814,1847,80.30434782608695,0
0,3,53,1399,41,0.03785714285714286,1452,34.57142857142857,0
0,0,764,162,23,4.6871165644171775,926,38.583333333333336,1
1,1,358,1114,28,0.32107623318385653,1472,50.758620689655174,0
1,1,335,1144,22,0.2925764192139738,1479,64.30434782608695,0
0,3,493,1025,139,0.48050682261208577,1518,10.842857142857143,0
2,0,0,564,47,0.0,564,11.75,0
0,2,628,402,42,1.5583126550868487,1030,23.953488372093023,0
1,0,666,401,29,1.6567164179104477,1067,35.56666666666667,0
0,0,1988,1058,22,1.8772426817752597,3046,132.43478260869566,0
1,3,595,551,12,1.0778985507246377,1146,88.15384615384616,0
1,0,451,330,45,1.3625377643504533,781,16.97826086956522,0
2,2,5248,785,6,6.676844783715013,6033,861.8571428571429,1
1,1,846,1451,1,0.5826446280991735,2297,1148.5,0
1,3,639,50,35,12.529411764705882,689,19.13888888888889,0
2,2,685,2864,4,0.23909249563699825,3549,709.8,0
1,1,1656,81,70,20.195121951219512,1737,24.464788732394368,1
2,3,416,573,44,0.7247386759581882,989,21.977777777777778,0
2,3,492,657,27,0.7477203647416414,1149,41.035714285714285,0
1,1,1410,118,11,11.84873949579832,1528,127.33333333333333,0
1,1,75,1977,30,0.037917087967644085,2052,66.19354838709677,0
0,2,2003,510,19,3.919765166340509,2513,125.65,1
2,0,562,123,10,4.532258064516129,685,62.27272727272727,0
0,0,870,994,87,0.8743718592964824,1864,21.181818181818183,0
1,0,1416,871,5,1.6238532110091743,2287,381.1666666666667,0
0,0,309,2634,41,0.11726755218216318,2943,70.07142857142857,0
2,0,2210,466,48,4.732334047109208,2676,54.61224489795919,1
0,2,3874,249,90,15.496,4123,45.30769230769231,0
2,3,681,49,23,13.62,730,30.416666666666668,1
1,2,2763,1056,22,2.6140018921475874,3819,166.04347826086956,0
1,2,1,768,75,0.0013003901170351106,769,10.118421052631579,0
2,2,2246,2878,48,0.7801319902744008,5124,104.57142857142857,1
1,3,372,996,43,0.3731193580742227,1368,31.09090909090909,0
1,2,373,2164,46,0.1722863741339492,2537,53.97872340425532,0
1,2,258,3821,20,0.06750392464678179,4079,194.23809523809524,0
1,3,381,447,1,0.8504464285714286,828,414.0,0
2,2,240,130,6,1.83206106870229,370,52.857142857142854,0
0,0,2363,174,30,13.502857142857144,2537,81.83870967741936,0
0,1,2292,306,15,7.465798045602606,2598,162.375,0
1,2,107,568,28,0.18804920913884007,675,23.275862068965516,0
0,1,154,104,24,1.4666666666666666,258,10.32,0
0,2,1980,287,17,6.875,2267,125.94444444444444,0
1,2,509,294,8,1.7254237288135594,803,89.22222222222223,0
1,0,185,3,38,46.25,188,4.82051282051282,0
0,3,714,349,71,2.04,1063,14.76388888888889,0
2,1,538,98,44,5.434343434343434,636,14.133333333333333,0
1,3,247,449,3,0.5488888888888889,696,174.0,0
2,0,1275,175,23,7.244318181818182,1450,60.416666666666664,0
0,0,997,1381,54,0.7214182344428365,2378,43.236363636363635,0
1,1,104,67,26,1.5294117647058822,171,6.333333333333333,0
2,3,2595,1605,17,1.615815691158157,4200,233.33333333333334,0
1,0,817,695,10,1.1738505747126438,1512,137.45454545454547,0
0,2,287,490,12,0.5845213849287169,777,59.76923076923077,0
2,2,231,638,8,0.3615023474178404,869,96.55555555555556,0
0,2,146,377,6,0.3862433862433862,523,74.71428571428571,0
0,3,552,109,26,5.0181818181818185,661,24.48148148148148,1
1,2,145,1161,21,0.12478485370051635,1306,59.36363636363637,0
2,2,537,2103,39,0.25522813688212925,2640,66.0,0
0,0,161,2397,11,0.06713928273561301,2558,213.16666666666666,0
0,0,1069,888,18,1.202474690663667,1957,103.0,0
2,2,1538,422,34,3.6359338061465722,1960,56.0,0
0,2,797,520,99,1.5297504798464492,1317,13.17,0
0,0,1139,855,12,1.330607476635514,1994,153.3846153846154,0
2,1,2786,1385,10,2.01010101010101,4171,379.1818181818182,0
2,3,1017,375,17,2.7047872340425534,1392,77.33333333333333,0
2,3,452,1989,38,0.2271356783919598,2441,62.58974358974359,0
2,0,596,313,97,1.8980891719745223,909,9.275510204081632,0
1,3,1969,605,23,3.2491749174917492,2574,107.25,0
2,0,140,2602,50,0.05378409527468306,2742,53.76470588235294,0
1,0,394,2227,18,0.17684021543985637,2621,137.94736842105263,0
1,0,861,951,1,0.9044117647058824,1812,906.0,0
1,0,1128,313,67,3.5923566878980893,1441,21.191176470588236,0
0,1,1441,197,10,7.277777777777778,1638,148.9090909090909,1
1,2,383,66,4,5.7164179104477615,449,89.8,0
1,2,157,986,166,0.1590678824721378,1143,6.844311377245509,0
0,1,3097,560,12,5.520499108734403,3657,281.3076923076923,0
0,3,79,679,4,0.1161764705882353,758,151.6,0
0,3,100,511,11,0.1953125,611,50.916666666666664,0
2,2,683,527,21,1.293560606060606,1210,55.0,0
0,3,1710,677,2,2.52212389380531,2387,795.6666666666666,0
0,2,1489,1965,13,0.7573753814852492,3454,246.71428571428572,0
1,2,2775,23,33,115.625,2798,82.29411764705883,1
0,1,152,1294,74,0.11737451737451737,1446,19.28,0
2,3,471,396,15,1.18639798488665,867,54.1875,0
0,1,331,1092,24,0.302836230558097,1423,56.92,0
2,2,1972,2373,30,0.8306655433866892,4345,140.16129032258064,0
0,2,670,292,2,2.2866894197952217,962,320.6666666666667,0
0,2,27,75,12,0.35526315789473684,102,7.846153846153846,0
0,0,1230,211,34,5.80188679245283,1441,41.17142857142857,1
0,0,492,200,39,2.4477611940298507,692,17.3,0
2,0,757,1083,13,0.698339483394834,1840,131.42857142857142,0
2,1,2242,51,0,43.11538461538461,2293,2293.0,0
1,2,296,41,0,7.0476190476190474,337,337.0,0
2,3,274,946,23,0.2893347412882788,1220,50.833333333333336,0
0,1,305,650,24,0.4685099846390169,955,38.2,0
1,1,412,432,24,0.9515011547344111,844,33.76,0
1,1,113,685,38,0.16472303206997085,798,20.46153846153846,0
1,3,1194,1063,76,1.1221804511278195,2257,29.31168831168831,0
0,2,232,87,138,2.6363636363636362,319,2.2949640287769784,0
2,0,2605,644,36,4.038759689922481,3249,87.8108108108108,0
0,2,242,1391,21,0.17385057471264367,1633,74.22727272727273,0
1,2,295,360,4,0.817174515235457,655,131.0,0
0,1,352,1151,14,0.3055555555555556,1503,100.2,0
0,1,1463,1493,25,0.9792503346720214,2956,113.6923076923077,0
2,1,557,1375,256,0.404796511627907,1932,7.517509727626459,0
2,0,1711,840,4,2.0344827586206895,2551,510.2,0
1,0,1536,1010,47,1.5192878338278932,2546,53.041666666666664,0
0,0,2652,1239,205,2.138709677419355,3891,18.888349514563107,0
0,2,1413,1058,49,1.3342776203966005,2471,49.42,0
2,1,53,480,43,0.1101871101871102,533,12.113636363636363,0
0,3,1815,138,8,13.057553956834532,1953,217.0,0
0,2,2781,296,0,9.363636363636363,3077,3077.0,1
0,0,5065,185,7,27.231182795698924,5250,656.25,0
2,3,133,358,46,0.37047353760445684,491,10.446808510638299,0
1,3,950,537,3,1.7657992565055762,1487,371.75,0
1,1,222,2556,10,0.08682049276495894,2778,252.54545454545453,0
0,3,304,2564,24,0.11851851851851852,2868,114.72,0
1,0,1368,1174,26,1.1642553191489362,2542,94.14814814814815,0
2,1,3801,3135,23,1.2120535714285714,6936,289.0,1
2,3,903,4978,118,0.18136171922072705,5881,49.42016806722689,0
1,1,1901,1732,0,1.0969417195614541,3633,3633.0,0
1,3,8,66,20,0.11940298507462686,74,3.5238095238095237,0
0,2,37,444,21,0.08314606741573034,481,21.863636363636363,0
1,2,908,611,10,1.4836601307189543,1519,138.0909090909091,0
0,0,492,105,22,4.6415094339622645,597,25.956521739130434,1
0,2,2205,1322,33,1.6666666666666667,3527,103.73529411764706,0
2,2,359,128,33,2.7829457364341086,487,14.323529411764707,0
2,2,565,386,2,1.4599483204134367,951,317.0,0
2,3,750,57,48,12.931034482758621,807,16.46938775510204,0
2,3,318,594,80,0.534453781512605,912,11.25925925925926,0
1,1,2391,727,3,3.284340659340659,3118,779.5,0
2,3,624,1062,16,0.5870178739416745,1686,99.17647058823529,0
1,2,551,331,21,1.6596385542168675,882,40.09090909090909,0
2,3,1895,714,4,2.6503496503496504,2609,521.8,0
1,0,373,1059,20,0.35188679245283017,1432,68.19047619047619,0
0,1,1700,1148,6,1.4795474325500435,2848,406.85714285714283,0
1,1,130,287,82,0.4513888888888889,417,5.024096385542169,0
1,3,201,56,17,3.526315789473684,257,14.277777777777779,0
2,2,3012,30,158,97.16129032258064,3042,19.132075471698112,0
1,1,1847,1169,1,1.5786324786324786,3016,1508.0,0
0,0,490,389,4,1.2564102564102564,879,175.8,0
0,0,1017,115,17,8.767241379310345,1132,62.888888888888886,0
2,1,2864,163,62,17.463414634146343,3027,48.04761904761905,0
0,2,238,1162,24,0.20464316423043852,1400,56.0,0
1,2,60,730,39,0.08207934336525308,790,19.75,0
0,3,771,556,16,1.3842010771992819,1327,78.05882352941177,0
2,3,153,780,1,0.19590268886043533,933,466.5,0
1,1,207,118,31,1.7394957983193278,325,10.15625,0
2,3,2221,307,30,7.211038961038961,2528,81.54838709677419,0
1,3,7,374,2,0.018666666666666668,381,127.0,0
0,3,1697,302,5,5.600660066006601,1999,333.1666666666667,0
2,0,727,1598,19,0.4546591619762351,2325,116.25,0
2,3,819,696,17,1.175035868005739,1515,84.16666666666667,0
1,1,1114,1045,41,1.0650095602294456,2159,51.404761904761905,0
2,2,564,216,14,2.5990783410138247,780,52.0,0
1,3,122,245,32,0.4959349593495935,367,11.121212121212121,0
1,2,108,204,36,0.526829268292683,312,8.432432432432432,0
1,3,1403,931,31,1.5053648068669527,2334,72.9375,0
1,1,249,343,27,0.7238372093023255,592,21.142857142857142,0
0,0,28,415,49,0.0673076923076923,443,8.86,0
1,1,3892,987,32,3.9392712550607287,4879,147.84848484848484,1
2,0,3931,2854,53,1.3768826619964973,6785,125.64814814814815,1
0,3,475,141,30,3.3450704225352115,616,19.870967741935484,0
2,3,25,51,5,0.4807692307692308,76,12.666666666666666,0
0,0,1299,173,11,7.4655172413793105,1472,122.66666666666667,0
1,1,1777,1062,12,1.671683913452493,2839,218.3846153846154,0
0,1,133,173,2,0.764367816091954,306,102.0,0
0,0,145,702,35,0.20625889046941678,847,23.52777777777778,0
2,3,1727,713,27,2.418767507002801,2440,87.14285714285714,0
2,0,2549,278,26,9.136200716845877,2827,104.70370370370371,0
1,3,1564,56,19,27.43859649122807,1620,81.0,0
0,0,224,407,23,0.5490196078431373,631,26.291666666666668,0
0,3,530,165,0,3.1927710843373496,695,695.0,0
0,0,918,163,3,5.597560975609756,1081,270.25,0
1,2,174,591,34,0.2939189189189189,765,21.857142857142858,0
1,3,236,894,9,0.2636871508379888,1130,113.0,0
1,1,332,62,3,5.26984126984127,394,98.5,0
1,0,712,690,11,1.0303907380607815,1402,116.83333333333333,0
1,1,714,226,8,3.145374449339207,940,104.44444444444444,0
2,0,1683,894,0,1.8804469273743016,2577,2577.0,0
0,1,1398,1329,15,1.0511278195488722,2727,170.4375,0
0,1,2450,1316,0,1.8602885345482156,3766,3766.0,0
0,0,1789,369,0,4.835135135135135,2158,2158.0,1
0,0,292,670,47,0.43517138599105815,962,20.041666666666668,0
0,1,402,1262,11,0.3182897862232779,1664,138.66666666666666,0
0,1,693,50,25,13.588235294117647,743,28.576923076923077,0
0,1,14,744,10,0.01879194630872483,758,68.9090909090909,0
0,3,2342,1448,79,1.6162870945479642,3790,47.375,0
2,3,45,372,39,0.12064343163538874,417,10.425,0
0,2,389,486,13,0.7987679671457906,875,62.5,0
2,3,842,959,7,0.8770833333333333,1801,225.125,0
1,3,729,56,4,12.789473684210526,785,157.0,0
0,0,1062,389,43,2.723076923076923,1451,32.97727272727273,0
1,2,749,280,18,2.6654804270462633,1029,54.1578947368421,0
1,2,260,13,7,18.571428571428573,273,34.125,1
1,3,224,174,75,1.28,398,5.2368421052631575,0
2,0,2377,403,14,5.883663366336633,2780,185.33333333333334,1
1,0,306,175,23,1.7386363636363635,481,20.041666666666668,0
1,2,329,737,58,0.44579945799457993,1066,18.06779661016949,0
1,0,532,476,53,1.1153039832285114,1008,18.666666666666668,0
0,1,150,32,30,4.545454545454546,182,5.870967741935484,0
0,3,707,257,65,2.74031007751938,964,14.606060606060606,0
2,1,1093,15,91,68.3125,1108,12.043478260869565,0
2,2,1541,354,82,4.340845070422535,1895,22.83132530120482,0
0,2,1242,239,12,5.175,1481,113.92307692307692,1
2,0,159,932,15,0.17041800643086816,1091,68.1875,0
0,0,608,293,8,2.068027210884354,901,100.11111111111111,0
1,2,39,376,54,0.10344827586206896,415,7.545454545454546,0
1,2,17,1033,3,0.01644100580270793,1050,262.5,0
2,1,580,524,13,1.1047619047619048,1104,78.85714285714286,0
0,1,291,650,0,0.4470046082949309,941,941.0,0
0,0,1149,1472,27,0.780040733197556,2621,93.60714285714286,0
2,1,1288,185,32,6.924731182795699,1473,44.63636363636363,0
0,0,2257,3621,8,0.6231363887355053,5878,653.1111111111111,0
1,0,1429,1842,40,0.7753662506782419,3271,79.78048780487805,0
2,3,49,270,14,0.18081180811808117,319,21.266666666666666,0
2,0,464,1787,11,0.2595078299776286,2251,187.58333333333334,0
0,1,318,1121,93,0.28342245989304815,1439,15.308510638297872,0
2,2,487,2136,26,0.22788956481048198,2623,97.14814814814815,0
0,2,174,939,8,0.1851063829787234,1113,123.66666666666667,0
0,1,102,897,122,0.11358574610244988,999,8.121951219512194,0
0,2,736,2,14,245.33333333333334,738,49.2,0
0,0,1274,514,31,2.4737864077669904,1788,55.875,0
0,2,1210,178,38,6.759776536312849,1388,35.58974358974359,1
2,1,599,313,16,1.9076433121019107,912,53.64705882352941,0
1,2,738,3083,23,0.23929961089494164,3821,159.20833333333334,0
1,0,726,71,8,10.083333333333334,797,88.55555555555556,1
2,0,1176,1025,18,1.1461988304093567,2201,115.84210526315789,0
2,1,49,151,11,0.3223684210526316,200,16.666666666666668,0
1,1,1237,5,23,206.16666666666666,1242,51.75,0
1,1,872,556,33,1.5655296229802513,1428,42.0,0
1,3,220,140,28,1.5602836879432624,360,12.413793103448276,0
1,3,50,2692,44,0.01856665428889714,2742,60.93333333333333,0
1,0,114,182,1,0.6229508196721312,296,148.0,0
0,3,743,170,2,4.345029239766082,913,304.3333333333333,0
2,3,1420,26,6,52.592592592592595,1446,206.57142857142858,0
0,2,407,320,127,1.2679127725856698,727,5.6796875,0
1,3,476,19,48,23.8,495,10.10204081632653,1
1,2,2720,552,77,4.918625678119349,3272,41.94871794871795,0
1,1,239,563,9,0.4237588652482269,802,80.2,0
0,2,109,43,25,2.477272727272727,152,5.846153846153846,0
0,2,420,219,24,1.9090909090909092,639,25.56,0
1,1,1370,1427,25,0.9593837535014006,2797,107.57692307692308,0
0,1,983,496,37,1.9778672032193159,1479,38.921052631578945,0
0,0,537,456,15,1.175054704595186,993,62.0625,0
1,0,3345,959,33,3.484375,4304,126.58823529411765,0
0,0,1328,1003,46,1.3227091633466135,2331,49.59574468085106,0
2,0,63,1148,10,0.05483028720626632,1211,110.0909090909091,0
2,2,1365,1419,87,0.9612676056338029,2784,31.636363636363637,0
2,2,24,211,21,0.11320754716981132,235,10.681818181818182,0
2,0,1050,54,39,19.09090909090909,1104,27.6,0
1,3,236,382,39,0.6161879895561357,618,15.45,0
1,0,1192,1545,24,0.7710219922380336,2737,109.48,0
1,3,370,64,11,5.6923076923076925,434,36.166666666666664,1
2,1,2063,686,32,3.002911208151383,2749,83.3030303030303,1
2,2,410,966,2,0.4239917269906929,1376,458.6666666666667,0
0,2,966,525,119,1.8365019011406845,1491,12.425,0
0,3,336,235,6,1.423728813559322,571,81.57142857142857,0
2,0,2491,315,9,7.882911392405063,2806,280.6,0
2,2,1518,59,92,25.3,1577,16.956989247311828,0
2,3,278,276,6,1.0036101083032491,554,79.14285714285714,0
2,1,2971,36,5,80.29729729729729,3007,501.1666666666667,0
0,1,441,1036,48,0.4252651880424301,1477,30.142857142857142,0
2,2,1055,1826,8,0.5774493705528189,2881,320.1111111111111,0
0,0,1358,803,2,1.6890547263681592,2161,720.3333333333334,0
2,3,23,855,7,0.026869158878504672,878,109.75,0
2,2,3193,511,65,6.236328125,3704,56.121212121212125,0
2,1,422,135,9,3.1029411764705883,557,55.7,0
0,0,210,6,35,30.0,216,6.0,0
0,3,1901,337,15,5.624260355029586,2238,139.875,0
1,2,1213,1113,9,1.0888689407540395,2326,232.6,0
2,3,90,2583,4,0.0348297213622291,2673,534.6,0
1,0,124,451,107,0.2743362831858407,575,5.324074074074074,0
1,0,1255,363,22,3.447802197802198,1618,70.34782608695652,1
0,1,77,472,3,0.16279069767441862,549,137.25,0
0,0,2491,446,6,5.572706935123042,2937,419.57142857142856,0
1,2,1353,786,15,1.7191867852604827,2139,133.6875,0
2,3,408,1059,23,0.3849056603773585,1467,61.125,0
0,0,450,1229,6,0.36585365853658536,1679,239.85714285714286,0
2,0,706,838,9,0.8414779499404053,1544,154.4,0
2,2,447,460,45,0.9696312364425163,907,19.717391304347824,0
1,3,1530,2398,16,0.637765735723218,3928,231.05882352941177,0
1,3,3678,993,0,3.700201207243461,4671,4671.0,1
1,1,878,445,1,1.968609865470852,1323,661.5,0
1,1,590,473,17,1.2447257383966244,1063,59.05555555555556,0
0,3,252,1362,1,0.18488628026412326,1614,807.0,0
0,2,1059,464,5,2.2774193548387096,1523,253.83333333333334,0
1,2,1157,580,39,1.991394148020654,1737,43.425,0
0,1,1155,275,19,4.184782608695652,1430,71.5,0
1,0,27,1460,19,0.018480492813141684,1487,74.35,0
2,2,2293,590,27,3.8798646362098137,2883,102.96428571428571,0
2,0,412,643,46,0.639751552795031,1055,22.4468085106383,0
2,2,1363,1700,5,0.8012933568489125,3063,510.5,0
1,3,1426,2025,5,0.7038499506416585,3451,575.1666666666666,0
2,1,1051,1390,3,0.7555715312724659,2441,610.25,0
0,0,502,54,82,9.127272727272727,556,6.698795180722891,0
2,0,937,468,25,1.9978678038379531,1405,54.03846153846154,0
2,3,41,336,2,0.12166172106824925,377,125.66666666666667,0
2,2,1435,192,7,7.435233160621761,1627,203.375,1
0,0,104,1917,38,0.054223149113660066,2021,51.82051282051282,0
1,2,505,1766,0,0.28579513299377474,2271,2271.0,0
0,3,109,500,38,0.21756487025948104,609,15.615384615384615,0
1,1,1814,115,72,15.637931034482758,1929,26.424657534246574,0
1,0,799,10,1,72.63636363636364,809,404.5,0
2,2,1174,461,6,2.5411255411255413,1635,233.57142857142858,0
1,0,1147,32,0,34.75757575757576,1179,1179.0,0
0,2,1842,752,3,2.446215139442231,2594,648.5,0
0,2,142,750,28,0.18908122503328895,892,30.75862068965517,0
1,2,1078,1833,1,0.5877862595419847,2911,1455.5,0
2,3,855,168,16,5.059171597633136,1023,60.1764705882353,0
2,1,31,371,20,0.08333333333333333,402,19.142857142857142,0
0,0,224,1570,71,0.14258434118395927,1794,24.916666666666668,0
2,1,311,514,19,0.6038834951456311,825,41.25,0
1,2,75,49,4,1.5,124,24.8,0
1,2,438,93,10,4.659574468085107,531,48.27272727272727,1
0,1,27,1343,33,0.020089285714285716,1370,40.294117647058826,0
1,1,805,1089,3,0.7385321100917431,1894,473.5,0
0,0,237,1669,7,0.14191616766467066,1906,238.25,0
1,2,338,101,164,3.3137254901960786,439,2.6606060606060606,0
0,1,2413,1143,0,2.109265734265734,3556,3556.0,0
2,3,698,851,4,0.8192488262910798,1549,309.8,0
1,2,313,211,55,1.4764150943396226,524,9.357142857142858,0
1,2,912,2916,3,0.31264998285910184,3828,957.0,0
0,0,225,675,1,0.3328402366863905,900,450.0,0
0,3,77,1899,3,0.04052631578947368,1976,494.0,0
1,0,21,1567,35,0.013392857142857142,1588,44.111111111111114,0
0,3,3026,324,149,9.31076923076923,3350,22.333333333333332,0
1,0,1289,614,26,2.0959349593495933,1903,70.48148148148148,0
2,3,1609,451,3,3.559734513274336,2060,515.0,0
0,3,3958,987,6,4.006072874493927,4945,706.4285714285714,1
1,3,2682,709,23,3.777464788732394,3391,141.29166666666666,1
2,1,1335,1229,37,1.0853658536585367,2564,67.47368421052632,0
2,2,1184,9,32,118.4,1193,36.15151515151515,0
1,3,410,931,25,0.43991416309012876,1341,51.57692307692308,0
0,1,109,307,128,0.3538961038961039,416,3.2248062015503876,0
1,1,852,203,6,4.176470588235294,1055,150.71428571428572,0
2,0,858,1292,5,0.6635730858468677,2150,358.3333333333333,0
1,2,3041,74,58,40.54666666666667,3115,52.79661016949152,1
0,2,584,207,10,2.8076923076923075,791,71.9090909090909,0
2,0,1173,182,12,6.409836065573771,1355,104.23076923076923,0
1,2,855,435,23,1.9610091743119267,1290,53.75,0
0,0,194,311,14,0.6217948717948718,505,33.666666666666664,0
2,1,896,1019,10,0.8784313725490196,1915,174.0909090909091,0
0,1,776,961,74,0.8066528066528067,1737,23.16,0
2,3,681,314,4,2.1619047619047618,995,199.0,0
1,0,720,459,15,1.565217391304348,1179,73.6875,0
0,1,179,186,0,0.9572192513368984,365,365.0,0
2,1,622,888,49,0.6996625421822272,1510,30.2,0
0,0,930,403,5,2.301980198019802,1333,222.16666666666666,0
0,1,672,114,44,5.843478260869565,786,17.466666666666665,0
1,2,670,108,4,6.146788990825688,778,155.6,0
0,1,80,311,16,0.2564102564102564,391,23.0,0
2,0,211,1100,39,0.1916439600363306,1311,32.775,0
2,2,387,20,9,18.428571428571427,407,40.7,1
2,2,543,238,11,2.271966527196653,781,65.08333333333333,0
2,1,901,141,33,6.345070422535211,1042,30.647058823529413,1
1,3,1990,2507,6,0.7934609250398724,4497,642.4285714285714,0
0,2,173,977,90,0.1768916155419223,1150,12.637362637362637,0
1,0,15,212,6,0.07042253521126761,227,32.42857142857143,0
0,3,596,186,41,3.1871657754010694,782,18.61904761904762,1
0,3,565,1561,48,0.3617157490396927,2126,43.38775510204081,0
0,2,802,168,14,4.745562130177515,970,64.66666666666667,1
1,1,1791,4663,5,0.38400514579759865,6454,1075.6666666666667,1
0,3,1621,265,5,6.093984962406015,1886,314.3333333333333,0
1,1,105,70,126,1.4788732394366197,175,1.3779527559055118,0
2,2,2718,939,38,2.891489361702128,3657,93.76923076923077,0
2,0,116,752,17,0.15405046480743692,868,48.22222222222222,0
0,3,1006,6907,8,0.14562825709322524,7913,879.2222222222222,1
1,0,1115,1295,0,0.8603395061728395,2410,2410.0,1
2,1,1139,448,33,2.5367483296213806,1587,46.6764705882353,0
1,1,308,903,94,0.3407079646017699,1211,12.74736842105263,0
1,0,400,1362,3,0.293470286133529,1762,440.5,0
0,2,795,576,42,1.3778162911611784,1371,31.88372093023256,0
2,2,222,254,4,0.8705882352941177,476,95.2,0
0,3,20,188,47,0.10582010582010581,208,4.333333333333333,0
0,3,825,279,13,2.9464285714285716,1104,78.85714285714286,0
2,2,626,1507,37,0.4151193633952255,2133,56.13157894736842,0
2,2,1069,382,78,2.7911227154046996,1451,18.367088607594937,0
1,0,158,270,29,0.5830258302583026,428,14.266666666666667,0
2,1,1838,1311,76,1.4009146341463414,3149,40.896103896103895,0
1,1,158,25,8,6.076923076923077,183,20.333333333333332,0
1,3,2219,721,114,3.0734072022160666,2940,25.565217391304348,0
1,2,596,1654,61,0.36012084592145016,2250,36.29032258064516,0
2,0,798,422,3,1.8865248226950355,1220,305.0,0
0,3,2268,251,16,9.0,2519,148.1764705882353,1
1,0,356,541,78,0.6568265682656826,897,11.354430379746836,0
0,2,200,1011,2,0.1976284584980237,1211,403.6666666666667,0
0,2,590,581,18,1.013745704467354,1171,61.63157894736842,0
2,2,280,6,38,40.0,286,7.333333333333333,0
0,1,750,65,1,11.363636363636363,815,407.5,0
0,2,321,1022,41,0.31378299120234604,1343,31.976190476190474,0
2,3,1998,408,13,4.885085574572127,2406,171.85714285714286,1
1,1,934,1228,8,0.7599674532139952,2162,240.22222222222223,0
0,0,0,838,25,0.0,838,32.23076923076923,0
2,3,1637,696,23,2.3486370157819225,2333,97.20833333333333,0
0,3,400,1853,62,0.21574973031283712,2253,35.76190476190476,0
0,0,385,17,33,21.38888888888889,402,11.823529411764707,1
1,1,482,134,16,3.5703703703703704,616,36.23529411764706,1
0,3,994,783,31,1.2678571428571428,1777,55.53125,0
2,3,583,54,41,10.6,637,15.166666666666666,1
0,3,990,828,83,1.1942098914354644,1818,21.642857142857142,0
1,1,158,3314,36,0.047662141779788836,3472,93.83783783783784,0
1,1,3512,1688,23,2.079336885731202,5200,216.66666666666666,1
2,1,1307,715,14,1.8254189944134078,2022,134.8,0
1,3,287,1795,66,0.15979955456570155,2082,31.074626865671643,0
0,2,1287,98,47,13.0,1385,28.854166666666668,0
1,0,855,485,2,1.7592592592592593,1340,446.6666666666667,0
2,2,115,447,36,0.25669642857142855,562,15.18918918918919,0
1,1,196,328,23,0.5957446808510638,524,21.833333333333332,0
1,3,42,0,3,42.0,42,10.5,1
1,3,1656,1773,24,0.9334836527621195,3429,137.16,0
2,2,802,1203,6,0.6661129568106312,2005,286.42857142857144,0
1,2,380,846,36,0.448642266824085,1226,33.13513513513514,0
1,0,135,110,9,1.2162162162162162,245,24.5,0
0,3,661,380,4,1.7349081364829397,1041,208.2,0
2,2,744,2065,2,0.3601161665053243,2809,936.3333333333334,0
1,0,1210,767,20,1.5755208333333333,1977,94.14285714285714,0
2,1,3504,739,6,4.735135135135135,4243,606.1428571428571,0
1,2,570,1954,57,0.2915601023017903,2524,43.51724137931034,0
1,1,520,656,0,0.791476407914764,1176,1176.0,0
1,0,461,728,55,0.6323731138545954,1189,21.232142857142858,0
0,1,1754,339,22,5.158823529411765,2093,91.0,0
0,3,169,371,76,0.4543010752688172,540,7.012987012987013,0
0,3,421,925,6,0.45464362850971923,1346,192.28571428571428,0
2,1,1290,309,3,4.161290322580645,1599,399.75,0
2,3,15,655,29,0.022865853658536585,670,22.333333333333332,0
0,0,341,261,36,1.3015267175572518,602,16.27027027027027,0
2,3,1025,145,13,7.02054794520548,1170,83.57142857142857,0
1,1,205,484,0,0.422680412371134,689,689.0,0
1,1,360,196,15,1.8274111675126903,556,34.75,0
1,1,665,1830,7,0.3631895139268159,2495,311.875,0
0,2,548,289,12,1.889655172413793,837,64.38461538461539,0
2,1,112,727,21,0.15384615384615385,839,38.13636363636363,0
0,0,2784,244,36,11.363265306122448,3028,81.83783783783784,0
2,3,45,238,99,0.18828451882845187,283,2.83,0
1,3,1385,345,4,4.002890173410405,1730,346.0,0
0,2,74,1980,34,0.03735487127713276,2054,58.68571428571428,0
2,2,629,397,7,1.5804020100502512,1026,128.25,0
2,0,192,1377,7,0.13933236574746008,1569,196.125,0
1,1,152,175,30,0.8636363636363636,327,10.548387096774194,0
0,2,134,39,44,3.35,173,3.8444444444444446,0
0,3,602,1217,114,0.4942528735632184,1819,15.817391304347826,0
0,2,724,624,43,1.1584,1348,30.636363636363637,0
1,2,143,560,5,0.2549019607843137,703,117.16666666666667,0
0,1,3882,254,7,15.223529411764705,4136,517.0,0
1,2,298,60,42,4.885245901639344,358,8.325581395348838,0
1,0,614,527,22,1.1628787878787878,1141,49.608695652173914,0
1,3,243,1615,10,0.15037128712871287,1858,168.9090909090909,0
2,1,681,102,19,6.611650485436893,783,39.15,0
0,3,1410,2117,73,0.6657223796033994,3527,47.66216216216216,0
0,0,736,256,42,2.8638132295719845,992,23.069767441860463,0
1,0,336,607,17,0.5526315789473685,943,52.388888888888886,0
1,2,285,55,118,5.089285714285714,340,2.857142857142857,0
0,2,1422,442,47,3.2099322799097068,1864,38.833333333333336,1
1,2,125,107,0,1.1574074074074074,232,232.0,0
0,3,461,39,3,11.525,500,125.0,0
2,0,164,2718,24,0.06031629275468922,2882,115.28,0
1,1,298,1047,12,0.28435114503816794,1345,103.46153846153847,0
0,2,165,1015,50,0.1624015748031496,1180,23.137254901960784,0
1,3,2178,75,67,28.657894736842106,2253,33.13235294117647,1
0,2,1316,2120,8,0.6204620462046204,3436,381.77777777777777,0
0,0,823,507,43,1.6200787401574803,1330,30.227272727272727,0
1,1,254,1529,22,0.16601307189542483,1783,77.52173913043478,0
2,0,713,10,14,64.81818181818181,723,48.2,0
0,3,735,283,46,2.5880281690140845,1018,21.659574468085108,0
0,2,892,4426,24,0.20149085159250057,5318,212.72,1
0,0,61,446,30,0.13646532438478748,507,16.35483870967742,0
2,3,3608,1754,1,2.055840455840456,5362,2681.0,1
2,2,626,317,26,1.9685534591194969,943,34.925925925925924,0
1,1,2610,596,10,4.371859296482412,3206,291.45454545454544,0
2,0,9,1540,20,0.005840363400389357,1549,73.76190476190476,0
1,2,284,744,7,0.3812080536912752,1028,128.5,0
1,2,109,1033,28,0.10541586073500966,1142,39.37931034482759,0
2,2,1468,207,4,7.0576923076923075,1675,335.0,0
1,2,385,135,3,2.8308823529411766,520,130.0,0
2,0,1835,209,6,8.738095238095237,2044,292.0,0
1,2,1786,543,51,3.2830882352941178,2329,44.78846153846154,0
2,3,1102,1291,1,0.8529411764705882,2393,1196.5,0
2,0,1095,349,39,3.1285714285714286,1444,36.1,0
1,2,1204,665,1,1.8078078078078077,1869,934.5,0
0,0,1120,1307,26,0.8562691131498471,2427,89.88888888888889,0
1,3,489,218,44,2.232876712328767,707,15.71111111111111,0
2,3,1148,1716,7,0.6686080372743156,2864,358.0,0
0,0,2276,2447,6,0.9297385620915033,4723,674.7142857142857,1
1,2,404,31,10,12.625,435,39.54545454545455,0
1,2,2898,48,36,59.142857142857146,2946,79.62162162162163,1
1,3,13,76,8,0.16883116883116883,89,9.88888888888889,0
0,2,429,1199,20,0.3575,1628,77.52380952380952,0
2,3,141,167,4,0.8392857142857143,308,61.6,0
1,2,135,1034,18,0.13043478260869565,1169,61.526315789473685,0
1,3,1689,465,29,3.624463519313305,2154,71.8,0
1,1,2505,1447,2,1.7299723756906078,3952,1317.3333333333333,0
1,2,1503,1322,50,1.1360544217687074,2825,55.3921568627451,0
1,2,3755,2568,83,1.461658232775399,6323,75.27380952380952,1
2,2,243,231,6,1.0474137931034482,474,67.71428571428571,0
2,0,151,208,42,0.722488038277512,359,8.348837209302326,0
1,2,735,25,11,28.26923076923077,760,63.333333333333336,1
0,0,1766,422,33,4.174940898345153,2188,64.3529411764706,0
2,0,40,491,10,0.08130081300813008,531,48.27272727272727,0
0,3,5418,2670,59,2.028453762635717,8088,134.8,1
2,0,921,1421,12,0.6476793248945147,2342,180.15384615384616,0
1,0,3860,145,56,26.438356164383563,4005,70.26315789473684,1
2,1,454,1281,43,0.3541341653666147,1735,39.43181818181818,0
1,2,612,157,6,3.8734177215189876,769,109.85714285714286,0
2,0,1395,64,5,21.46153846153846,1459,243.16666666666666,0
1,2,1573,1451,45,1.0833333333333333,3024,65.73913043478261,0
1,0,265,2982,14,0.08883674153536708,3247,216.46666666666667,0
1,3,2656,73,89,35.891891891891895,2729,30.322222222222223,1
1,1,2020,1345,85,1.50074294205052,3365,39.127906976744185,0
0,0,18,1568,35,0.011472275334608031,1586,44.05555555555556,0
1,2,137,101,20,1.3431372549019607,238,11.333333333333334,0
0,3,685,266,6,2.5655430711610485,951,135.85714285714286,0
0,2,617,1058,64,0.5826251180358829,1675,25.76923076923077,0
1,3,1232,1319,2,0.9333333333333333,2551,850.3333333333334,0
0,1,93,349,13,0.26571428571428574,442,31.571428571428573,0
2,3,1035,139,11,7.392857142857143,1174,97.83333333333333,1
1,2,958,836,95,1.1445639187574672,1794,18.6875,0
0,2,266,968,3,0.27450980392156865,1234,308.5,0
1,0,781,560,66,1.392156862745098,1341,20.01492537313433,0
1,3,251,125,18,1.992063492063492,376,19.789473684210527,0
1,2,158,1488,1,0.1061114842175957,1646,823.0,0
0,0,851,829,39,1.0253012048192771,1680,42.0,0
2,1,3793,1627,3,2.32985257985258,5420,1355.0,0
2,2,270,2162,8,0.12482662968099861,2432,270.22222222222223,0
0,0,439,1310,48,0.3348588863463005,1749,35.69387755102041,0
1,2,296,2548,5,0.11612397018438603,2844,474.0,0
0,3,309,2467,11,0.12520259319286872,2776,231.33333333333334,0
0,0,517,772,13,0.6688227684346701,1289,92.07142857142857,0
0,3,1210,1042,26,1.1601150527325024,2252,83.4074074074074,0
1,1,39,961,46,0.04054054054054054,1000,21.27659574468085,0
0,3,3149,776,7,4.052767052767053,3925,490.625,1
1,0,47,15,6,2.9375,62,8.857142857142858,0
0,2,2130,351,7,6.051136363636363,2481,310.125,0
2,0,2247,84,14,26.435294117647057,2331,155.4,1
0,3,743,285,22,2.597902097902098,1028,44.69565217391305,0
0,3,147,56,0,2.5789473684210527,203,203.0,0
2,2,832,2020,45,0.41167738743196436,2852,62.0,0
1,1,990,480,78,2.058212058212058,1470,18.60759493670886,0
1,0,1950,167,55,11.607142857142858,2117,37.80357142857143,0
0,2,800,703,1,1.1363636363636365,1503,751.5,0
2,2,528,174,22,3.0171428571428573,702,30.52173913043478,0
1,2,1821,1305,50,1.394333843797856,3126,61.294117647058826,0
0,0,3960,292,12,13.515358361774744,4252,327.0769230769231,0
2,0,1035,302,68,3.4158415841584158,1337,19.3768115942029,1
1,0,2074,1631,65,1.2708333333333333,3705,56.13636363636363,0
1,1,913,655,4,1.391768292682927,1568,313.6,0
2,2,1170,1746,20,0.6697195191757298,2916,138.85714285714286,0
2,3,1165,426,0,2.728337236533958,1591,1591.0,0
2,3,1220,337,9,3.6094674556213016,1557,155.7,1
2,2,387,564,50,0.6849557522123894,951,18.647058823529413,0
0,3,857,50,110,16.80392156862745,907,8.17117117117117,0
2,1,901,133,73,6.723880597014926,1034,13.972972972972974,0
1,1,378,198,1,1.899497487437186,576,288.0,0
1,0,430,1357,78,0.3166421207658321,1787,22.620253164556964,0
0,0,1436,1058,51,1.355996222851747,2494,47.96153846153846,0
1,0,874,171,60,5.0813953488372094,1045,17.131147540983605,0
1,0,161,259,73,0.6192307692307693,420,5.675675675675675,0
2,0,1817,2309,20,0.7865800865800866,4126,196.47619047619048,0
1,3,2146,71,7,29.805555555555557,2217,277.125,0
0,3,627,634,0,0.9874015748031496,1261,1261.0,0
2,0,234,590,0,0.39593908629441626,824,824.0,0
2,1,2948,1034,30,2.8483091787439614,3982,128.4516129032258,0
0,3,2139,242,12,8.802469135802468,2381,183.15384615384616,0
2,1,280,2183,20,0.1282051282051282,2463,117.28571428571429,0
2,1,100,422,4,0.2364066193853428,522,104.4,0
0,2,580,269,111,2.1481481481481484,849,7.580357142857143,0
2,2,1128,328,4,3.4285714285714284,1456,291.2,0
0,0,192,343,17,0.5581395348837209,535,29.72222222222222,0
0,1,719,177,17,4.03932584269663,896,49.77777777777778,0
1,3,554,2105,0,0.2630579297245964,2659,2659.0,1
1,2,2212,153,33,14.363636363636363,2365,69.55882352941177,0
2,2,561,1715,23,0.3269230769230769,2276,94.83333333333333,0
2,1,763,415,20,1.8341346153846154,1178,56.095238095238095,0
0,2,3107,250,51,12.378486055776893,3357,64.5576923076923,0
2,2,356,177,8,2.0,533,59.22222222222222,0
0,3,341,561,59,0.6067615658362989,902,15.033333333333333,0
0,1,1607,885,60,1.8137697516930023,2492,40.85245901639344,0
2,2,325,1827,52,0.17778993435448578,2152,40.60377358490566,0
0,1,1782,845,12,2.106382978723404,2627,202.07692307692307,0
1,2,100,528,5,0.1890359168241966,628,104.66666666666667,0
2,3,117,27,19,4.178571428571429,144,7.2,0
1,1,2315,1976,9,1.170966110268083,4291,429.1,0
2,2,778,1861,1,0.4178302900107411,2639,1319.5,0
0,3,1268,380,9,3.3280839895013123,1648,164.8,0
2,2,255,23,18,10.625,278,14.631578947368421,1
1,1,181,1057,3,0.17107750472589792,1238,309.5,0
0,2,1801,1254,86,1.4350597609561753,3055,35.11494252873563,0
2,1,444,625,32,0.7092651757188498,1069,32.39393939393939,0
2,1,607,412,4,1.4697336561743342,1019,203.8,0
2,2,28,1523,50,0.01837270341207349,1551,30.41176470588235,0
1,3,487,171,78,2.8313953488372094,658,8.329113924050633,0
1,0,1471,463,9,3.1702586206896552,1934,193.4,0
2,3,1721,19,4,86.05,1740,348.0,0
0,3,1199,143,11,8.32638888888889,1342,111.83333333333333,0
0,2,1178,2261,53,0.5207780725022104,3439,63.68518518518518,0
1,3,705,690,5,1.020260492040521,1395,232.5,0
0,3,772,1310,45,0.5888634630053394,2082,45.26086956521739,0
1,0,1357,533,37,2.541198501872659,1890,49.73684210526316,0
2,3,284,1440,31,0.1970853573907009,1724,53.875,0
1,0,263,619,17,0.4241935483870968,882,49.0,0
1,2,2994,3,13,748.5,2997,214.07142857142858,1
2,0,28,1839,2,0.015217391304347827,1867,622.3333333333334,0
0,1,150,128,13,1.1627906976744187,278,19.857142857142858,0
1,1,844,479,27,1.7583333333333333,1323,47.25,0
1,0,1338,518,68,2.578034682080925,1856,26.89855072463768,0
2,1,771,38,53,19.76923076923077,809,14.981481481481481,0
0,2,438,43,0,9.954545454545455,481,481.0,0
1,1,3815,1150,4,3.314509122502172,4965,993.0,0
2,0,1216,285,56,4.251748251748252,1501,26.333333333333332,1
1,2,1780,421,84,4.218009478672986,2201,25.894117647058824,0
2,1,41,664,1,0.061654135338345864,705,352.5,0
0,2,269,373,36,0.7192513368983957,642,17.35135135135135,0
0,0,468,1193,13,0.39195979899497485,1661,118.64285714285714,0
0,1,201,1726,13,0.11638679791546033,1927,137.64285714285714,0
0,2,75,49,30,1.5,124,4.0,0
1,2,255,807,49,0.3155940594059406,1062,21.24,0
1,1,762,305,9,2.4901960784313726,1067,106.7,0
0,2,1189,700,36,1.696148359486448,1889,51.054054054054056,0
0,2,1487,529,30,2.8056603773584907,2016,65.03225806451613,0
0,0,43,324,21,0.13230769230769232,367,16.681818181818183,0
1,0,558,79,27,6.975,637,22.75,1
0,0,130,655,0,0.19817073170731708,785,785.0,0
0,0,564,95,0,5.875,659,659.0,1
0,0,569,135,23,4.1838235294117645,704,29.333333333333332,1
2,0,689,3221,22,0.2138423339540658,3910,170.0,0
0,1,2233,304,2,7.321311475409836,2537,845.6666666666666,0
2,0,1635,702,20,2.32574679943101,2337,111.28571428571429,0
2,2,1012,254,42,3.9686274509803923,1266,29.441860465116278,0
0,1,2166,1605,23,1.348692403486924,3771,157.125,0
2,2,1134,266,21,4.247191011235955,1400,63.63636363636363,1
0,0,1708,365,37,4.666666666666667,2073,54.55263157894737,1
1,0,829,749,5,1.1053333333333333,1578,263.0,0
1,2,744,1632,18,0.4556031843233313,2376,125.05263157894737,0
1,2,1287,1355,4,0.9491150442477876,2642,528.4,0
1,2,19,245,22,0.07723577235772358,264,11.478260869565217,0
2,3,1172,1415,26,0.827683615819209,2587,95.81481481481481,0
0,3,2725,966,3,2.81799379524302,3691,922.75,0
0,3,1251,3670,2,0.3407790792699537,4921,1640.3333333333333,1
0,3,37,2192,5,0.0168718650250798,2229,371.5,0
1,1,474,609,26,0.7770491803278688,1083,40.111111111111114,0
1,0,1658,1108,6,1.4950405770964834,2766,395.14285714285717,0
0,2,3184,675,9,4.710059171597633,3859,385.9,1
1,0,462,723,36,0.638121546961326,1185,32.027027027027025,0
0,2,1840,85,8,21.3953488372093,1925,213.88888888888889,0
0,0,1993,1,15,996.5,1994,124.625,0
0,1,131,39,79,3.275,170,2.125,0
0,3,1869,2720,52,0.6868798235942668,4589,86.58490566037736,0
0,0,391,107,8,3.6203703703703702,498,55.333333333333336,0
0,2,899,36,27,24.2972972972973,935,33.392857142857146,0
0,0,774,296,32,2.606060606060606,1070,32.42424242424242,0
1,1,1087,709,69,1.5309859154929577,1796,25.65714285714286,0
0,1,1348,2372,23,0.5680573114201433,3720,155.0,0
0,0,581,962,24,0.6033229491173416,1543,61.72,0
1,3,2192,258,65,8.463320463320464,2450,37.121212121212125,0
1,2,1658,2238,1,0.7405091558731577,3896,1948.0,0
1,1,1539,29,29,51.3,1568,52.266666666666666,1
0,1,612,3092,16,0.19786614936954414,3704,217.88235294117646,0
2,0,38,48,72,0.7755102040816326,86,1.178082191780822,0
2,1,677,1121,96,0.6033868092691622,1798,18.536082474226806,0
1,1,2287,37,5,60.18421052631579,2324,387.3333333333333,0
2,2,211,2145,9,0.0983224603914259,2356,235.6,0
1,3,4050,92,9,43.54838709677419,4142,414.2,0
0,2,1648,41,3,39.23809523809524,1689,422.25,1
2,3,1237,1760,19,0.7024417944349801,2997,149.85,0
0,2,1130,80,21,13.950617283950617,1210,55.0,1
2,0,884,1279,25,0.690625,2163,83.1923076923077,0
0,1,1275,1099,32,1.1590909090909092,2374,71.93939393939394,0
2,3,548,730,1,0.7496580027359782,1278,639.0,0
0,0,1866,379,29,4.910526315789474,2245,74.83333333333333,0
0,1,1191,1977,73,0.602123356926188,3168,42.810810810810814,0
2,1,1475,1638,18,0.8999389871873094,3113,163.8421052631579,0
0,1,1572,444,3,3.5325842696629213,2016,504.0,0
0,2,96,210,2,0.4549763033175355,306,102.0,0
0,0,57,254,9,0.2235294117647059,311,31.1,0
2,0,1614,199,41,8.07,1813,43.166666666666664,0
2,1,300,623,9,0.4807692307692308,923,92.3,0
0,3,872,1623,50,0.5369458128078818,2495,48.92156862745098,0
0,0,586,1188,51,0.4928511354079058,1774,34.11538461538461,0
2,2,22,1269,18,0.01732283464566929,1291,67.94736842105263,0
2,3,41,475,10,0.0861344537815126,516,46.90909090909091,0
0,3,1755,311,27,5.625,2066,73.78571428571429,0
0,3,935,1132,49,0.8252427184466019,2067,41.34,0
0,3,742,1261,2,0.5879556259904913,2003,667.6666666666666,0
1,0,2888,950,91,3.036803364879075,3838,41.71739130434783,0
2,1,190,26,31,7.037037037037037,216,6.75,0
1,3,298,712,15,0.4179523141654979,1010,63.125,0
2,2,1413,340,21,4.1436950146627565,1753,79.68181818181819,1
2,2,1492,174,14,8.525714285714285,1666,111.06666666666666,0
2,1,519,948,15,0.5468914646996839,1467,91.6875,0
2,0,3015,250,27,12.01195219123506,3265,116.60714285714286,0
2,1,2784,1952,1,1.4254992319508448,4736,2368.0,0
2,3,12,283,5,0.04225352112676056,295,49.166666666666664,0
2,0,189,648,7,0.29121725731895226,837,104.625,0
1,0,1716,1407,15,1.21875,3123,195.1875,0
0,3,408,411,13,0.9902912621359223,819,58.5,0
0,2,100,1411,38,0.0708215297450425,1511,38.743589743589745,0
1,3,1537,1029,8,1.492233009708738,2566,285.1111111111111,0
1,1,606,2029,1,0.29852216748768473,2635,1317.5,0
1,3,678,315,1,2.1455696202531644,993,496.5,0
1,2,206,88,0,2.3146067415730336,294,294.0,0
2,3,1081,450,1,2.3968957871396896,1531,765.5,0
0,1,801,1232,58,0.6496350364963503,2033,34.45762711864407,0
2,1,231,478,35,0.4822546972860125,709,19.694444444444443,0
0,2,416,243,165,1.7049180327868851,659,3.9698795180722892,0
0,1,908,22,0,39.47826086956522,930,930.0,0
1,1,2588,300,56,8.598006644518273,2888,50.666666666666664,1
2,3,2530,999,35,2.53,3529,98.02777777777777,0
1,0,339,127,30,2.6484375,466,15.03225806451613,0
2,1,1330,333,13,3.9820359281437128,1663,118.78571428571429,0
0,1,1493,16,14,87.82352941176471,1509,100.6,0
1,2,1654,1023,56,1.615234375,2677,46.96491228070175,0
1,2,845,1700,37,0.496766607877719,2545,66.97368421052632,0
0,3,10,672,33,0.014858841010401188,682,20.058823529411764,0
0,3,1434,20,0,68.28571428571429,1454,1454.0,0
0,1,112,196,6,0.5685279187817259,308,44.0,0
1,0,124,461,98,0.2683982683982684,585,5.909090909090909,0
2,0,930,708,18,1.311706629055007,1638,86.21052631578948,0
1,3,4105,548,45,7.477231329690346,4653,101.15217391304348,0
2,2,277,1980,14,0.1398283695103483,2257,150.46666666666667,0
1,1,1037,2232,43,0.464397671294223,3269,74.29545454545455,0
1,1,361,90,3,3.967032967032967,451,112.75,1
0,0,2289,119,1,19.075,2408,1204.0,0
2,3,900,354,18,2.535211267605634,1254,66.0,0
1,0,232,437,26,0.5296803652968036,669,24.77777777777778,0
1,0,303,705,11,0.42917847025495753,1008,84.0,0
0,3,566,1186,37,0.476832350463353,1752,46.10526315789474,0
0,2,130,116,20,1.1111111111111112,246,11.714285714285714,0
2,1,82,1298,79,0.06312548113933796,1380,17.25,0
1,2,1139,753,2,1.5106100795755968,1892,630.6666666666666,0
2,3,522,3165,2,0.16487681617182565,3687,1229.0,0
1,3,1295,842,70,1.5361803084223014,2137,30.098591549295776,0
2,1,116,1007,33,0.11507936507936507,1123,33.029411764705884,0
0,2,941,173,33,5.408045977011494,1114,32.76470588235294,0
1,1,585,1171,0,0.4991467576791809,1756,1756.0,0
2,0,59,66,83,0.8805970149253731,125,1.4880952380952381,0
0,0,787,854,44,0.92046783625731,1641,36.46666666666667,0
0,0,86,45,43,1.8695652173913044,131,2.977272727272727,0
2,2,1758,97,72,17.93877551020408,1855,25.410958904109588,0
1,0,999,91,25,10.858695652173912,1090,41.92307692307692,0
1,1,814,43,15,18.5,857,53.5625,0
0,2,143,309,19,0.4612903225806452,452,22.6,0
1,1,338,4141,45,0.0816030902945437,4479,97.3695652173913,0
1,3,678,342,43,1.9766763848396502,1020,23.181818181818183,0
1,2,1003,1144,28,0.8759825327510917,2147,74.03448275862068,0
0,1,202,113,7,1.7719298245614035,315,39.375,0
2,1,8,484,51,0.016494845360824743,492,9.461538461538462,0
1,2,422,163,31,2.573170731707317,585,18.28125,0
0,3,659,170,7,3.853801169590643,829,103.625,0
0,2,203,84,19,2.388235294117647,287,14.35,0
2,0,677,452,176,1.4944812362030906,1129,6.378531073446328,0
1,0,413,62,11,6.555555555555555,475,39.583333333333336,1
1,3,607,1924,3,0.31532467532467534,2531,632.75,0
2,1,426,475,0,0.8949579831932774,901,901.0,0
2,1,990,1458,6,0.67854694996573,2448,349.7142857142857,0
0,1,43,3108,6,0.0138308137664844,3151,450.14285714285717,0
0,2,187,906,58,0.2061742006615215,1093,18.52542372881356,0
2,2,566,1854,5,0.3051212938005391,2420,403.3333333333333,0
1,3,440,116,59,3.7606837606837606,556,9.266666666666667,0
0,0,496,1417,2,0.34978843441466856,1913,637.6666666666666,0
0,1,1628,253,71,6.409448818897638,1881,26.125,1
1,0,2174,511,8,4.24609375,2685,298.3333333333333,0
0,2,285,832,28,0.34213685474189676,1117,38.51724137931034,0
1,2,1810,1870,5,0.9673971138428648,3680,613.3333333333334,0
1,2,613,1935,14,0.31663223140495866,2548,169.86666666666667,0
1,0,319,77,2,4.089743589743589,396,132.0,1
2,3,4230,362,25,11.652892561983471,4592,176.6153846153846,1
2,3,1741,1260,12,1.380650277557494,3001,230.84615384615384,0
2,2,5159,971,57,5.30761316872428,6130,105.6896551724138,1
1,1,184,21,6,8.363636363636363,205,29.285714285714285,1
1,0,155,478,9,0.3235908141962422,633,63.3,0
2,2,699,1414,5,0.4939929328621908,2113,352.1666666666667,0
0,0,1017,1070,24,0.9495798319327731,2087,83.48,0
1,0,187,424,3,0.44,611,152.75,0
0,3,1969,1062,6,1.8523047977422389,3031,433.0,0
0,2,759,640,34,1.1840873634945397,1399,39.97142857142857,0
1,3,529,1950,2,0.27114300358790366,2479,826.3333333333334,0
1,2,921,707,40,1.3008474576271187,1628,39.707317073170735,0
0,0,1007,409,3,2.4560975609756097,1416,354.0,0
0,3,43,1589,26,0.027044025157232705,1632,60.44444444444444,0
2,0,9139,40,183,222.90243902439025,9179,49.88586956521739,1
2,2,452,1846,5,0.24472116946399566,2298,383.0,0
1,1,63,953,9,0.0660377358490566,1016,101.6,0
2,3,1912,2258,68,0.8463922089420097,4170,60.43478260869565,0
2,3,4964,230,29,21.48917748917749,5194,173.13333333333333,0
2,0,1694,949,20,1.783157894736842,2643,125.85714285714286,0
2,0,1909,1326,24,1.4385832705350414,3235,129.4,0
0,1,983,968,10,1.0144478844169247,1951,177.36363636363637,0
1,3,2555,188,57,13.518518518518519,2743,47.293103448275865,1
2,2,36,257,41,0.13953488372093023,293,6.976190476190476,0
0,2,1455,669,30,2.171641791044776,2124,68.51612903225806,0
0,3,1110,473,80,2.3417721518987342,1583,19.54320987654321,0
0,3,50,1062,25,0.047036688617121354,1112,42.76923076923077,0
2,3,785,380,21,2.0603674540682415,1165,52.95454545454545,0
2,1,723,1569,111,0.4605095541401274,2292,20.464285714285715,0
1,2,1176,452,6,2.596026490066225,1628,232.57142857142858,0
2,2,80,32,4,2.4242424242424243,112,22.4,0
2,0,1636,14,5,109.06666666666666,1650,275.0,0
0,0,150,832,136,0.18007202881152462,982,7.1678832116788325,0
1,3,542,622,31,0.869983948635634,1164,36.375,0
2,0,2131,626,10,3.398724082934609,2757,250.63636363636363,0
2,1,822,1248,8,0.6581265012009607,2070,230.0,0
0,2,477,376,1,1.2652519893899203,853,426.5,0
0,2,49,4313,4,0.011358368103847936,4362,872.4,1
2,0,1115,2328,71,0.47874624302275653,3443,47.81944444444444,0
1,3,4308,10,41,391.6363636363636,4318,102.80952380952381,0
1,0,2428,1808,85,1.342177998894417,4236,49.25581395348837,0
0,3,1263,912,16,1.3833515881708653,2175,127.94117647058823,0
0,1,111,557,27,0.1989247311827957,668,23.857142857142858,0
2,2,273,699,19,0.39,972,48.6,0
0,1,206,1475,63,0.13956639566395665,1681,26.265625,0
2,2,439,2413,142,0.18185584092792045,2852,19.944055944055943,0
1,1,268,657,80,0.4072948328267477,925,11.419753086419753,0
1,0,280,160,27,1.7391304347826086,440,15.714285714285714,0
2,1,959,816,1,1.1738066095471236,1775,887.5,0
0,1,383,63,28,5.984375,446,15.379310344827585,1
1,0,1130,806,3,1.4002478314745972,1936,484.0,0
0,2,2954,1322,4,2.232804232804233,4276,855.2,0
1,2,1017,348,6,2.9140401146131807,1365,195.0,0
2,0,1392,59,13,23.2,1451,103.64285714285714,0
2,1,1392,942,26,1.4761399787910923,2334,86.44444444444444,0
2,1,401,331,12,1.2078313253012047,732,56.30769230769231,0
1,1,15,229,18,0.06521739130434782,244,12.842105263157896,0
0,3,56,934,1,0.059893048128342244,990,495.0,0
0,2,331,2794,29,0.11842576028622541,3125,104.16666666666667,0
0,1,1169,1094,32,1.067579908675799,2263,68.57575757575758,0
1,2,2371,540,3,4.382624768946395,2911,727.75,0
1,1,3189,734,46,4.338775510204082,3923,83.46808510638297,1
1,0,26,122,31,0.21138211382113822,148,4.625,0
1,0,4613,1342,20,3.434847356664185,5955,283.57142857142856,0
1,2,389,741,24,0.5242587601078167,1130,45.2,0
0,2,1851,2701,20,0.6850481125092525,4552,216.76190476190476,1
1,0,198,3109,1,0.06366559485530547,3307,1653.5,0
1,3,64,350,39,0.18233618233618235,414,10.35,0
0,0,475,3575,21,0.13282997762863535,4050,184.0909090909091,0
1,1,1958,2514,5,0.7785288270377734,4472,745.3333333333334,0
0,3,249,816,34,0.3047735618115055,1065,30.428571428571427,0
0,0,167,324,35,0.5138461538461538,491,13.63888888888889,0
2,3,2405,1119,7,2.1473214285714284,3524,440.5,0
2,3,2786,253,47,10.968503937007874,3039,63.3125,1
2,3,12,795,18,0.01507537688442211,807,42.473684210526315,0
2,2,1299,19,5,64.95,1318,219.66666666666666,0
1,0,369,792,32,0.46532156368221944,1161,35.18181818181818,0
2,2,469,2422,27,0.19356170037144035,2891,103.25,0
0,2,633,214,5,2.944186046511628,847,141.16666666666666,0
1,1,556,1204,61,0.46141078838174276,1760,28.387096774193548,0
2,1,723,277,57,2.6007194244604315,1000,17.24137931034483,0
0,3,873,984,54,0.8862944162436548,1857,33.763636363636365,0
1,3,626,963,15,0.6493775933609959,1589,99.3125,0
1,1,1209,163,52,7.371951219512195,1372,25.88679245283019,0
2,1,1267,727,55,1.7403846153846154,1994,35.607142857142854,0
1,0,580,1568,169,0.36966220522625876,2148,12.635294117647058,0
0,3,153,385,94,0.3963730569948187,538,5.663157894736842,0
1,3,1023,991,14,1.03125,2014,134.26666666666668,0
0,1,1482,897,6,1.6503340757238307,2379,339.85714285714283,0
1,0,1016,238,10,4.2510460251046025,1254,114.0,0
2,1,886,2007,20,0.44123505976095617,2893,137.76190476190476,0
0,1,260,663,49,0.39156626506024095,923,18.46,0
1,2,1036,351,38,2.9431818181818183,1387,35.56410256410256,0
1,3,407,143,46,2.826388888888889,550,11.702127659574469,0
1,0,2520,513,14,4.902723735408561,3033,202.2,0
0,2,1060,1047,8,1.0114503816793894,2107,234.11111111111111,0
0,3,325,781,0,0.4156010230179028,1106,1106.0,0
0,1,640,1038,29,0.6159769008662175,1678,55.93333333333333,0
2,0,1874,1255,47,1.4920382165605095,3129,65.1875,0
2,3,408,465,65,0.8755364806866953,873,13.227272727272727,0
0,1,745,587,19,1.2670068027210883,1332,66.6,0
1,2,1138,3439,78,0.3308139534883721,4577,57.936708860759495,0
2,0,1404,2754,6,0.5096188747731397,4158,594.0,0
0,3,191,428,21,0.44522144522144524,619,28.136363636363637,0
1,2,832,924,7,0.8994594594594595,1756,219.5,0
2,1,2432,249,6,9.728,2681,383.0,0
1,1,3453,132,91,25.962406015037594,3585,38.96739130434783,0
1,3,1067,1170,51,0.9111870196413322,2237,43.01923076923077,0
1,1,4114,458,0,8.962962962962964,4572,4572.0,1
1,0,845,155,9,5.416666666666667,1000,100.0,0
2,3,584,1137,6,0.5131810193321616,1721,245.85714285714286,0
2,2,802,1973,4,0.40628166160081053,2775,555.0,0
2,3,122,2165,35,0.05632502308402586,2287,63.52777777777778,0
0,3,513,725,25,0.7066115702479339,1238,47.61538461538461,0
2,2,613,522,18,1.1720841300191205,1135,59.73684210526316,0
1,1,1888,122,6,15.34959349593496,2010,287.14285714285717,0
2,2,1421,1259,9,1.1277777777777778,2680,268.0,0
1,0,919,2325,13,0.39509888220120376,3244,231.71428571428572,0
0,1,426,1761,46,0.24177071509648126,2187,46.53191489361702,0
1,3,207,1114,135,0.18565022421524663,1321,9.713235294117647,0
1,1,427,3,6,106.75,430,61.42857142857143,0
1,1,1138,419,12,2.7095238095238097,1557,119.76923076923077,0
0,0,305,423,9,0.7193396226415094,728,72.8,0
2,1,556,1798,1,0.30906058921623125,2354,1177.0,0
2,1,489,54,7,8.89090909090909,543,67.875,0
0,1,1450,606,69,2.3887973640856672,2056,29.37142857142857,0
1,3,2152,117,55,18.23728813559322,2269,40.517857142857146,0
2,1,1201,868,5,1.38204833141542,2069,344.8333333333333,0
0,2,417,1257,13,0.3314785373608903,1674,119.57142857142857,0
2,1,567,821,11,0.6897810218978102,1388,115.66666666666667,0
0,0,154,1266,4,0.12154696132596685,1420,284.0,0
1,1,184,748,29,0.24566088117489987,932,31.066666666666666,0
2,1,179,168,24,1.0591715976331362,347,13.88,0
0,3,139,385,16,0.3601036269430052,524,30.823529411764707,0
2,2,197,2514,58,0.07833001988071571,2711,45.94915254237288,0
2,1,226,271,29,0.8308823529411765,497,16.566666666666666,0
2,2,118,51,9,2.269230769230769,169,16.9,0
2,0,1022,388,14,2.627249357326478,1410,94.0,0
0,3,4646,364,4,12.728767123287671,5010,1002.0,1
1,2,2113,508,26,4.1512770137524555,2621,97.07407407407408,0
0,3,46,657,26,0.06990881458966565,703,26.037037037037038,0
0,1,550,3906,61,0.14077297158945482,4456,71.87096774193549,0
0,0,1961,1129,58,1.7353982300884956,3090,52.3728813559322,0
1,3,144,29,54,4.8,173,3.1454545454545455,0
2,1,1881,997,23,1.8847695390781563,2878,119.91666666666667,0
2,2,898,1390,31,0.6455787203450755,2288,71.5,0
2,0,2677,1807,44,1.480641592920354,4484,99.64444444444445,0
1,0,2087,441,2,4.721719457013575,2528,842.6666666666666,0
2,2,1130,301,10,3.7417218543046356,1431,130.0909090909091,0
1,2,1072,1462,5,0.732740943267259,2534,422.3333333333333,0
2,0,239,1202,21,0.19866999168744803,1441,65.5,0
2,3,124,614,54,0.2016260162601626,738,13.418181818181818,0
0,0,536,100,7,5.306930693069307,636,79.5,0
1,2,206,843,39,0.24407582938388625,1049,26.225,0
0,3,108,54,15,1.9636363636363636,162,10.125,0
0,1,360,84,70,4.235294117647059,444,6.253521126760563,1
0,0,1969,321,29,6.114906832298137,2290,76.33333333333333,0
1,2,17,371,112,0.0456989247311828,388,3.433628318584071,0
1,1,346,495,8,0.6975806451612904,841,93.44444444444444,0
2,0,551,331,77,1.6596385542168675,882,11.307692307692308,0
0,0,714,27,13,25.5,741,52.92857142857143,0
2,3,200,137,29,1.4492753623188406,337,11.233333333333333,0
0,2,3330,97,5,33.97959183673469,3427,571.1666666666666,0
1,1,864,451,42,1.9115044247787611,1315,30.58139534883721,0
1,0,738,190,114,3.863874345549738,928,8.069565217391304,0
1,3,8,277,46,0.02877697841726619,285,6.0638297872340425,0
0,1,664,510,28,1.299412915851272,1174,40.48275862068966,0
1,1,1818,214,17,8.455813953488372,2032,112.88888888888889,0
0,0,248,225,12,1.0973451327433628,473,36.38461538461539,0
2,1,432,1432,16,0.30146545708304257,1864,109.6470588235294,0
0,0,20,635,11,0.031446540880503145,655,54.583333333333336,0
2,3,3769,1554,53,2.4237942122186493,5323,98.57407407407408,1
0,3,68,578,67,0.11744386873920552,646,9.5,0
2,1,2284,1919,89,1.1895833333333334,4203,46.7,0
1,0,375,235,16,1.5889830508474576,610,35.88235294117647,0
2,2,885,767,23,1.15234375,1652,68.83333333333333,0
1,3,1137,559,25,2.030357142857143,1696,65.23076923076923,0
1,0,151,2007,31,0.075199203187251,2158,67.4375,0
2,0,586,433,0,1.3502304147465438,1019,1019.0,0
0,0,393,1543,55,0.2545336787564767,1936,34.57142857142857,0
0,1,58,663,9,0.08734939759036145,721,72.1,0
0,2,1790,986,19,1.8135764944275583,2776,138.8,0
0,1,46,1743,55,0.026376146788990827,1789,31.946428571428573,0
0,3,1059,4622,172,0.2290720311486048,5681,32.83815028901734,1
1,1,376,1050,47,0.3577545195052331,1426,29.708333333333332,0
0,0,213,302,0,0.7029702970297029,515,515.0,0
1,1,1099,284,13,3.856140350877193,1383,98.78571428571429,1
1,0,854,295,8,2.885135135135135,1149,127.66666666666667,0
1,2,378,82,99,4.554216867469879,460,4.6,0
2,1,719,44,9,15.977777777777778,763,76.3,0
2,1,282,695,86,0.4051724137931034,977,11.229885057471265,0
1,1,1992,1331,83,1.4954954954954955,3323,39.55952380952381,0
2,0,376,29,54,12.533333333333333,405,7.363636363636363,1
0,0,281,668,3,0.4200298953662182,949,237.25,0
0,1,1393,371,0,3.7446236559139785,1764,1764.0,1
1,1,17,1784,47,0.009523809523809525,1801,37.520833333333336,0
0,2,311,125,55,2.4682539682539684,436,7.785714285714286,0
1,2,470,663,98,0.7078313253012049,1133,11.444444444444445,0
1,3,2139,2830,7,0.7555634051571882,4969,621.125,1
0,2,3004,338,39,8.861356932153392,3342,83.55,0
2,2,1260,1083,21,1.1623616236162362,2343,106.5,0
0,2,678,1712,11,0.3957968476357268,2390,199.16666666666666,0
0,0,1023,164,27,6.2,1187,42.392857142857146,0
1,2,534,3917,23,0.1362940275650842,4451,185.45833333333334,0
1,2,354,1326,10,0.266767143933685,1680,152.72727272727272,0
1,1,3009,118,9,25.285714285714285,3127,312.7,0
1,0,122,297,19,0.40939597315436244,419,20.95,0
2,3,425,784,19,0.5414012738853503,1209,60.45,0
2,3,2293,1729,10,1.3254335260115606,4022,365.6363636363636,0
2,2,1284,173,9,7.379310344827586,1457,145.7,0
1,3,29,1051,92,0.027566539923954372,1080,11.612903225806452,0
1,3,23,252,59,0.09090909090909091,275,4.583333333333333,0
1,3,726,1309,50,0.5541984732824428,2035,39.90196078431372,0
2,2,662,920,7,0.7187839305103149,1582,197.75,0
1,3,585,592,6,0.9865092748735245,1177,168.14285714285714,0
0,2,360,839,49,0.42857142857142855,1199,23.98,0
0,1,4315,1672,6,2.57919904363419,5987,855.2857142857143,0
1,1,317,390,21,0.8107416879795396,707,32.13636363636363,0
0,3,673,1173,7,0.5732538330494037,1846,230.75,0
0,1,519,138,14,3.7338129496402876,657,43.8,0
2,2,186,966,57,0.1923474663908997,1152,19.862068965517242,0
1,1,226,1111,66,0.20323741007194246,1337,19.955223880597014,0
1,3,2504,468,171,5.339019189765459,2972,17.27906976744186,0
2,2,1953,1262,86,1.5463182897862233,3215,36.95402298850575,0
0,0,221,651,33,0.3389570552147239,872,25.647058823529413,0
0,2,2084,2202,16,0.9459827507943713,4286,252.11764705882354,0
1,1,234,95,1,2.4375,329,164.5,0
0,0,984,112,28,8.70796460176991,1096,37.793103448275865,0
2,2,84,1478,7,0.056795131845841784,1562,195.25,0
2,0,2123,1477,56,1.4364005412719891,3600,63.1578947368421,0
1,0,52,509,23,0.10196078431372549,561,23.375,0
2,0,809,2658,39,0.30424971793907485,3467,86.675,0
2,2,1512,910,33,1.659714599341383,2422,71.23529411764706,0
1,1,124,3252,12,0.03811865969873963,3376,259.6923076923077,0
2,2,518,608,42,0.8505747126436781,1126,26.186046511627907,0
2,1,42,180,55,0.23204419889502761,222,3.9642857142857144,0
2,2,1148,470,40,2.4373673036093417,1618,39.46341463414634,0
0,2,367,3149,44,0.1165079365079365,3516,78.13333333333334,0
1,2,819,370,13,2.207547169811321,1189,84.92857142857143,0
1,1,2699,2517,86,1.0718824463860206,5216,59.95402298850575,1
1,2,365,1275,16,0.28605015673981193,1640,96.47058823529412,0
0,0,49,466,68,0.10492505353319058,515,7.463768115942029,0
0,2,1125,624,58,1.8,1749,29.64406779661017,0
1,0,1545,748,3,2.062750333778371,2293,573.25,0
0,3,3166,876,101,3.6100342075256555,4042,39.627450980392155,1
1,3,171,63,168,2.671875,234,1.3846153846153846,0
0,1,497,2169,27,0.22903225806451613,2666,95.21428571428571,0
2,1,1858,727,45,2.552197802197802,2585,56.19565217391305,0
2,3,1644,2140,81,0.7678654834189631,3784,46.146341463414636,0
1,2,980,799,0,1.225,1779,1779.0,0
0,2,313,451,79,0.6924778761061947,764,9.55,0
0,2,334,669,29,0.49850746268656715,1003,33.43333333333333,0
2,3,132,1415,52,0.09322033898305085,1547,29.18867924528302,0
2,0,2549,315,23,8.066455696202532,2864,119.33333333333333,0
0,1,189,2507,22,0.07535885167464115,2696,117.21739130434783,0
0,0,850,501,68,1.6932270916334662,1351,19.579710144927535,0
0,3,877,2503,21,0.3502396166134185,3380,153.63636363636363,0
0,0,461,1701,19,0.2708578143360752,2162,108.1,0
0,2,434,1167,28,0.3715753424657534,1601,55.206896551724135,0
0,2,1104,504,21,2.1861386138613863,1608,73.0909090909091,0
1,0,491,707,17,0.693502824858757,1198,66.55555555555556,0
0,3,294,1456,5,0.20178448867536034,1750,291.6666666666667,0
2,0,509,628,15,0.809220985691574,1137,71.0625,0
1,2,1648,1072,9,1.5358807082945014,2720,272.0,0
0,2,3395,1251,15,2.711661341853035,4646,290.375,1
2,3,1010,575,26,1.7534722222222223,1585,58.7037037037037,0
1,0,1523,614,28,2.4764227642276424,2137,73.6896551724138,0
2,2,761,176,8,4.299435028248587,937,104.11111111111111,0
0,2,980,224,2,4.355555555555555,1204,401.3333333333333,0
0,0,4430,1882,40,2.3526287838555495,6312,153.9512195121951,0
0,0,576,1467,22,0.3923705722070845,2043,88.82608695652173,0
0,1,68,8,17,7.555555555555555,76,4.222222222222222,1
1,3,3146,1628,4,1.9312461632903621,4774,954.8,0
1,3,1575,20,16,75.0,1595,93.82352941176471,1
2,0,508,490,51,1.034623217922607,998,19.192307692307693,0
0,3,4039,55,26,72.125,4094,151.62962962962962,0
2,2,423,2774,2,0.15243243243243243,3197,1065.6666666666667,0
1,0,465,2869,12,0.16202090592334495,3334,256.46153846153845,0
0,0,940,755,117,1.2433862433862435,1695,14.364406779661017,0
0,0,320,398,23,0.8020050125313283,718,29.916666666666668,0
1,1,1199,573,10,2.0888501742160277,1772,161.0909090909091,0
1,3,165,1149,73,0.14347826086956522,1314,17.756756756756758,0
1,1,114,202,12,0.5615763546798029,316,24.307692307692307,0
1,2,765,466,39,1.6381156316916488,1231,30.775,0
1,3,810,1069,4,0.7570093457943925,1879,375.8,0
0,1,112,402,5,0.27791563275434245,514,85.66666666666667,0
1,0,3329,26,24,123.29629629629629,3355,134.2,0
0,1,851,566,8,1.5008818342151675,1417,157.44444444444446,0
0,0,163,1069,1,0.15233644859813084,1232,616.0,0
1,1,373,3011,78,0.12383798140770252,3384,42.835443037974684,0
1,1,1610,30,1,51.935483870967744,1640,820.0,0
0,1,740,621,37,1.189710610932476,1361,35.81578947368421,0
1,0,208,478,12,0.4342379958246347,686,52.76923076923077,0
1,1,108,222,81,0.484304932735426,330,4.024390243902439,0
1,3,563,812,128,0.6924969249692496,1375,10.65891472868217,0
2,3,411,142,12,2.874125874125874,553,42.53846153846154,0
0,3,1066,267,26,3.9776119402985075,1333,49.370370370370374,0
2,0,2593,1217,44,2.1288998357963873,3810,84.66666666666667,0
1,0,284,493,3,0.5748987854251012,777,194.25,0
2,3,1932,4050,37,0.4769192791903234,5982,157.42105263157896,1
1,3,2531,390,70,6.4731457800511505,2921,41.140845070422536,0
2,3,2322,497,5,4.662650602409639,2819,469.8333333333333,1
1,2,3038,285,54,10.622377622377622,3323,60.41818181818182,0
2,3,1845,215,3,8.541666666666666,2060,515.0,0
2,1,900,2043,25,0.44031311154598823,2943,113.1923076923077,0
2,2,527,1105,12,0.47649186256781195,1632,125.53846153846153,0
0,2,676,324,19,2.08,1000,50.0,0
2,0,2060,963,10,2.136929460580913,3023,274.8181818181818,0
0,1,358,2700,9,0.1325435024065161,3058,305.8,0
1,0,173,61,40,2.7903225806451615,234,5.7073170731707314,0
2,0,151,245,7,0.6138211382113821,396,49.5,0
1,1,1754,179,15,9.744444444444444,1933,120.8125,0
1,0,1433,1630,9,0.8786020846106684,3063,306.3,0
2,1,688,157,8,4.3544303797468356,845,93.88888888888889,1
0,1,321,294,29,1.088135593220339,615,20.5,0
2,0,1132,627,1,1.802547770700637,1759,879.5,0
1,3,39,776,46,0.05019305019305019,815,17.340425531914892,0
1,0,839,1320,23,0.6351249053747161,2159,89.95833333333333,0
2,2,508,418,52,1.2124105011933175,926,17.471698113207548,0
0,0,3810,611,7,6.2254901960784315,4421,552.625,1
0,1,708,2692,37,0.2629038247307835,3400,89.47368421052632,0
1,2,803,282,16,2.8374558303886928,1085,63.8235294117647,0
1,1,1246,228,2,5.441048034934497,1474,491.3333333333333,1
0,3,662,991,41,0.6673387096774194,1653,39.357142857142854,0
2,3,254,1179,43,0.21525423728813559,1433,32.56818181818182,0
1,2,770,428,9,1.794871794871795,1198,119.8,0
0,3,2887,191,74,15.036458333333334,3078,41.04,0
1,3,527,1207,43,0.43625827814569534,1734,39.40909090909091,0
2,0,1138,888,10,1.2800899887514061,2026,184.1818181818182,0
0,0,3818,1671,8,2.2834928229665072,5489,609.8888888888889,0
1,3,1771,1487,17,1.1901881720430108,3258,181.0,0
2,3,1075,183,10,5.842391304347826,1258,114.36363636363636,0
1,0,1331,1428,7,0.9314205738278516,2759,344.875,0
2,3,2756,154,15,17.780645161290323,2910,181.875,0
2,3,3212,1594,0,2.013793103448276,4806,4806.0,1
0,1,3472,1176,15,2.949872557349193,4648,290.5,1
2,3,982,674,7,1.4548148148148148,1656,207.0,0
1,2,485,822,9,0.5893074119076549,1307,130.7,0
2,1,142,87,2,1.6136363636363635,229,76.33333333333333,0
2,2,487,32,26,14.757575757575758,519,19.22222222222222,0
0,3,2863,321,19,8.891304347826088,3184,159.2,0
2,0,2205,1378,41,1.598984771573604,3583,85.30952380952381,0
2,1,741,501,130,1.4760956175298805,1242,9.48091603053435,0
1,0,770,202,3,3.793103448275862,972,243.0,1
0,1,369,1439,9,0.25625,1808,180.8,0
0,0,606,207,34,2.9134615384615383,813,23.228571428571428,0
0,1,1253,1352,8,0.9260901699926091,2605,289.44444444444446,0
2,1,514,482,0,1.0641821946169772,996,996.0,0
0,2,208,498,3,0.4168336673346693,706,176.5,0
2,0,778,254,17,3.0509803921568626,1032,57.333333333333336,0
2,2,255,1843,16,0.13828633405639915,2098,123.41176470588235,0
1,2,3660,74,107,48.8,3734,34.574074074074076,0
1,0,494,124,18,3.952,618,32.526315789473685,0
1,1,2404,808,34,2.9715698393077874,3212,91.77142857142857,0
1,2,255,1518,20,0.16787360105332455,1773,84.42857142857143,0
1,0,209,80,9,2.580246913580247,289,28.9,0
2,1,959,1058,3,0.9055712936732767,2017,504.25,0
2,2,1511,1085,58,1.3913443830570902,2596,44.0,0
0,2,836,696,4,1.199426111908178,1532,306.4,0
2,2,261,533,3,0.4887640449438202,794,198.5,0
2,1,38,309,7,0.12258064516129032,347,43.375,0
1,2,963,346,0,2.7752161383285303,1309,1309.0,0
2,1,140,897,2,0.155902004454343,1037,345.6666666666667,0
1,3,420,54,30,7.636363636363637,474,15.290322580645162,0
0,2,1126,703,8,1.5994318181818181,1829,203.22222222222223,0
0,3,103,261,12,0.3931297709923664,364,28.0,0
2,0,136,502,54,0.27037773359840955,638,11.6,0
0,2,63,654,44,0.09618320610687023,717,15.933333333333334,0
2,0,5541,1734,20,3.1936599423631122,7275,346.42857142857144,1
0,0,489,692,28,0.7056277056277056,1181,40.724137931034484,0
1,0,2362,206,2,11.41062801932367,2568,856.0,0
1,3,347,66,43,5.17910447761194,413,9.386363636363637,0
1,1,1399,788,21,1.773130544993663,2187,99.4090909090909,0
1,3,247,630,25,0.39144215530903326,877,33.73076923076923,0
2,3,689,891,32,0.7724215246636771,1580,47.878787878787875,0
0,0,1740,492,20,3.5294117647058822,2232,106.28571428571429,0
2,2,1694,1394,22,1.214336917562724,3088,134.2608695652174,0
1,1,1581,2022,20,0.7815126050420168,3603,171.57142857142858,0
2,0,1735,32,20,52.57575757575758,1767,84.14285714285714,0
0,1,237,1090,41,0.21723189734188816,1327,31.595238095238095,0
2,3,658,28,16,22.689655172413794,686,40.35294117647059,0
0,1,663,471,0,1.4046610169491525,1134,1134.0,0
2,1,2211,495,28,4.457661290322581,2706,93.3103448275862,1
0,2,352,953,91,0.3689727463312369,1305,14.184782608695652,0
0,0,2680,347,8,7.7011494252873565,3027,336.3333333333333,0
1,1,599,1375,50,0.43531976744186046,1974,38.705882352941174,0
0,1,1108,335,18,3.2976190476190474,1443,75.94736842105263,0
1,3,313,335,30,0.9315476190476191,648,20.903225806451612,0
1,3,528,201,66,2.613861386138614,729,10.880597014925373,0
1,1,1237,921,44,1.341648590021692,2158,47.955555555555556,0
2,0,718,63,64,11.21875,781,12.015384615384615,0
2,1,2669,360,0,7.393351800554017,3029,3029.0,1
2,1,1336,248,6,5.365461847389558,1584,226.28571428571428,0
2,2,831,208,16,3.9760765550239237,1039,61.11764705882353,0
0,0,2177,50,56,42.68627450980392,2227,39.07017543859649,0
0,2,1095,168,54,6.479289940828402,1263,22.963636363636365,0
2,0,1042,472,6,2.2029598308668077,1514,216.28571428571428,0
0,0,282,560,4,0.5026737967914439,842,168.4,0
0,0,502,251,54,1.992063492063492,753,13.690909090909091,0
1,2,1149,840,23,1.366230677764566,1989,82.875,0
1,2,2223,327,29,6.777439024390244,2550,85.0,0
1,2,379,366,49,1.0326975476839237,745,14.9,0
1,3,242,1220,7,0.1981981981981982,1462,182.75,0
0,2,900,642,4,1.3996889580093312,1542,308.4,0
2,3,69,2449,58,0.02816326530612245,2518,42.67796610169491,0
0,3,1253,356,3,3.5098039215686274,1609,402.25,1
0,3,1214,1407,2,0.8622159090909091,2621,873.6666666666666,0
0,1,438,1072,9,0.4082013047530289,1510,151.0,0
1,1,2231,1767,11,1.2618778280542986,3998,333.1666666666667,0
1,1,697,2513,8,0.27724741447891804,3210,356.6666666666667,0
1,3,1037,6,40,148.14285714285714,1043,25.4390243902439,0
2,3,235,73,108,3.175675675675676,308,2.8256880733944953,0
0,0,540,897,6,0.6013363028953229,1437,205.28571428571428,0
2,3,1983,395,45,5.007575757575758,2378,51.69565217391305,1
1,1,239,1367,1,0.17470760233918128,1606,803.0,0
2,3,495,9,3,49.5,504,126.0,1
0,3,382,1315,21,0.29027355623100304,1697,77.13636363636364,0
0,0,163,116,235,1.393162393162393,279,1.1822033898305084,0
1,3,342,274,89,1.2436363636363637,616,6.844444444444444,0
1,2,264,2781,3,0.09489575844716032,3045,761.25,0
2,0,2571,42,8,59.7906976744186,2613,290.3333333333333,1
1,3,1351,343,87,3.927325581395349,1694,19.25,0
1,3,379,70,4,5.338028169014085,449,89.8,0
0,0,1441,1537,40,0.9369310793237972,2978,72.63414634146342,0
1,3,22,971,0,0.02263374485596708,993,993.0,0
1,1,747,1288,29,0.5795190069821567,2035,67.83333333333333,0
0,2,288,599,20,0.48,887,42.23809523809524,0
0,2,121,354,19,0.3408450704225352,475,23.75,0
2,1,2152,1,53,1076.0,2153,39.870370370370374,1
1,3,222,260,2,0.8505747126436781,482,160.66666666666666,0
0,3,1728,578,14,2.9844559585492227,2306,153.73333333333332,0
2,2,533,873,17,0.6098398169336384,1406,78.11111111111111,0
2,3,14,207,3,0.0673076923076923,221,55.25,0
1,2,1318,119,2,10.983333333333333,1437,479.0,1
1,2,907,180,5,5.011049723756906,1087,181.16666666666666,0
2,1,421,349,8,1.2028571428571428,770,85.55555555555556,0
0,2,330,128,101,2.558139534883721,458,4.490196078431373,0
2,3,76,136,19,0.5547445255474452,212,10.6,0
1,3,2837,35,21,78.80555555555556,2872,130.54545454545453,0
0,0,681,1554,36,0.4379421221864952,2235,60.4054054054054,0
0,3,89,198,34,0.4472361809045226,287,8.2,0
2,0,2030,1380,20,1.4699493120926865,3410,162.38095238095238,0
1,2,326,461,12,0.7056277056277056,787,60.53846153846154,0
2,3,227,800,12,0.2833957553058677,1027,79.0,0
2,1,329,62,1,5.222222222222222,391,195.5,0
2,1,831,700,68,1.1854493580599144,1531,22.18840579710145,0
0,1,76,273,44,0.2773722627737226,349,7.7555555555555555,0
0,2,657,80,29,8.11111111111111,737,24.566666666666666,0
1,2,2260,1910,15,1.1826268969126112,4170,260.625,0
1,0,208,740,26,0.2807017543859649,948,35.111111111111114,0
2,1,402,221,19,1.8108108108108107,623,31.15,0
2,0,504,435,9,1.1559633027522935,939,93.9,0
2,0,882,353,10,2.4915254237288136,1235,112.27272727272727,0
1,3,2516,964,62,2.607253886010363,3480,55.23809523809524,0
0,3,501,748,30,0.6688918558077437,1249,40.29032258064516,0
0,1,71,15,0,4.4375,86,86.0,0
2,2,427,176,11,2.4124293785310735,603,50.25,0
2,3,210,520,12,0.40307101727447214,730,56.15384615384615,0
2,2,1054,471,36,2.233050847457627,1525,41.21621621621622,0
2,0,29,581,36,0.04982817869415808,610,16.486486486486488,0
1,0,345,1003,18,0.3436254980079681,1348,70.94736842105263,0
0,0,787,916,90,0.8582333696837514,1703,18.714285714285715,0
2,0,324,373,61,0.8663101604278075,697,11.241935483870968,0
1,1,800,1680,60,0.4759071980963712,2480,40.65573770491803,0
2,0,121,52,12,2.2830188679245285,173,13.307692307692308,0
2,3,2861,702,16,4.069701280227596,3563,209.58823529411765,0
0,0,343,2391,16,0.14339464882943143,2734,160.8235294117647,0
2,2,2563,637,17,4.017241379310345,3200,177.77777777777777,0
0,3,394,485,66,0.8106995884773662,879,13.119402985074627,0
0,2,1522,115,8,13.120689655172415,1637,181.88888888888889,0
0,2,282,1329,48,0.21203007518796993,1611,32.87755102040816,0
1,1,1107,374,21,2.952,1481,67.31818181818181,0
1,1,391,966,8,0.4043433298862461,1357,150.77777777777777,0
0,2,711,176,22,4.016949152542373,887,38.56521739130435,1
2,2,1120,34,6,32.0,1154,164.85714285714286,0
0,0,888,291,3,3.041095890410959,1179,294.75,0
2,3,858,264,54,3.237735849056604,1122,20.4,0
0,0,67,1653,36,0.04050785973397823,1720,46.486486486486484,0
2,1,286,1600,6,0.17863835103060588,1886,269.42857142857144,0
1,1,848,610,85,1.387888707037643,1458,16.953488372093023,0
2,0,18,15,0,1.125,33,33.0,0
0,3,288,207,12,1.3846153846153846,495,38.07692307692308,0
1,2,260,815,0,0.31862745098039214,1075,1075.0,0
2,0,287,85,4,3.3372093023255816,372,74.4,0
2,1,767,964,5,0.794818652849741,1731,288.5,0
2,3,872,9,49,87.2,881,17.62,0
2,1,2396,917,149,2.610021786492375,3313,22.086666666666666,0
2,3,487,1489,60,0.3268456375838926,1976,32.39344262295082,0
1,3,2611,506,30,5.149901380670611,3117,100.54838709677419,1
1,3,1055,1413,38,0.7461103253182461,2468,63.282051282051285,0
1,0,2437,1216,22,2.0024650780608053,3653,158.82608695652175,0
1,0,1792,890,16,2.011223344556678,2682,157.76470588235293,0
0,0,1163,471,35,2.4639830508474576,1634,45.388888888888886,0
1,3,440,253,108,1.7322834645669292,693,6.3577981651376145,0
2,3,275,1577,0,0.17427122940430925,1852,1852.0,0
2,1,251,836,11,0.2998805256869773,1087,90.58333333333333,0
1,2,3040,1279,12,2.375,4319,332.2307692307692,0
2,0,3183,642,16,4.950233281493001,3825,225.0,0
1,3,1290,150,29,8.543046357615895,1440,48.0,1
2,1,2152,3107,21,0.6924066924066924,5259,239.04545454545453,0
0,1,2513,161,0,15.512345679012345,2674,2674.0,0
0,1,716,1937,15,0.36945304437564497,2653,165.8125,0
1,0,991,186,28,5.2994652406417115,1177,40.58620689655172,1
1,0,542,374,21,1.4453333333333334,916,41.63636363636363,0
1,2,542,463,61,1.168103448275862,1005,16.20967741935484,0
2,1,39,2034,15,0.019164619164619166,2073,129.5625,0
1,0,568,1752,0,0.3240159726183685,2320,2320.0,0
0,1,1119,1386,10,0.8067772170151406,2505,227.72727272727272,0
2,3,548,378,4,1.445910290237467,926,185.2,0
1,1,2058,3,8,514.5,2061,229.0,0
2,2,404,915,13,0.4410480349344978,1319,94.21428571428571,0
2,0,142,423,33,0.33490566037735847,565,16.61764705882353,0
1,3,1668,1131,11,1.4734982332155477,2799,233.25,0
2,0,1120,1267,64,0.8832807570977917,2387,36.723076923076924,0
0,3,276,463,10,0.5948275862068966,739,67.18181818181819,0
0,1,768,1102,4,0.6962828649138713,1870,374.0,0
2,1,513,1465,5,0.3499317871759891,1978,329.6666666666667,0
1,2,2794,2110,81,1.3235433443865467,4904,59.80487804878049,1
2,2,934,698,18,1.3361945636623749,1632,85.89473684210526,0
0,3,172,1205,15,0.14262023217247097,1377,86.0625,0
2,2,697,545,2,1.2765567765567765,1242,414.0,0
2,2,1984,34,39,56.68571428571428,2018,50.45,1
0,2,1113,134,35,8.244444444444444,1247,34.638888888888886,0
2,2,1848,109,14,16.8,1957,130.46666666666667,0
2,1,288,150,35,1.9072847682119205,438,12.166666666666666,0
1,2,2192,8,13,243.55555555555554,2200,157.14285714285714,0
1,1,1408,1565,2,0.8991060025542784,2973,991.0,0
0,1,1305,657,40,1.9832826747720365,1962,47.853658536585364,0
0,0,425,386,100,1.0981912144702843,811,8.029702970297029,0
0,1,2186,421,31,5.180094786729858,2607,81.46875,1
1,1,1016,497,9,2.040160642570281,1513,151.3,0
0,2,1909,61,9,30.79032258064516,1970,197.0,0
0,1,447,256,79,1.7392996108949417,703,8.7875,0
0,3,157,1526,10,0.10281597904387688,1683,153.0,0
1,2,403,1089,43,0.3697247706422018,1492,33.90909090909091,0
2,2,607,663,30,0.9141566265060241,1270,40.96774193548387,0
0,2,762,524,26,1.4514285714285715,1286,47.629629629629626,0
2,0,715,239,5,2.9791666666666665,954,159.0,0
0,2,789,509,1,1.5470588235294118,1298,649.0,0
2,1,1843,728,20,2.5281207133058983,2571,122.42857142857143,0
1,3,186,997,133,0.18637274549098196,1183,8.828358208955224,0
1,2,379,145,6,2.595890410958904,524,74.85714285714286,0
0,2,2194,1341,23,1.6348733233979136,3535,147.29166666666666,0
2,3,822,339,33,2.4176470588235293,1161,34.14705882352941,0
1,2,875,559,19,1.5625,1434,71.7,0
0,0,650,748,21,0.8678237650200267,1398,63.54545454545455,0
0,1,796,535,32,1.4850746268656716,1331,40.333333333333336,0
1,3,220,678,50,0.3240058910162003,898,17.607843137254903,0
1,3,791,94,12,8.326315789473684,885,68.07692307692308,0
0,0,5868,452,68,12.95364238410596,6320,91.59420289855072,1
2,1,834,263,19,3.159090909090909,1097,54.85,0
2,0,45,71,32,0.625,116,3.515151515151515,0
2,1,1591,170,3,9.304093567251462,1761,440.25,1
0,0,504,737,20,0.6829268292682927,1241,59.095238095238095,0
1,2,166,175,0,0.9431818181818182,341,341.0,0
0,0,1984,159,14,12.4,2143,142.86666666666667,0
1,3,220,643,1,0.3416149068322981,863,431.5,0
2,3,2535,1880,68,1.3476874003189792,4415,63.98550724637681,1
2,3,583,1243,33,0.46864951768488744,1826,53.705882352941174,0
1,0,1357,1883,47,0.720276008492569,3240,67.5,0
1,3,791,699,18,1.13,1490,78.42105263157895,0
0,3,296,422,57,0.6997635933806147,718,12.379310344827585,0
2,2,1111,1046,61,1.061127029608405,2157,34.79032258064516,0
0,2,3168,242,13,13.037037037037036,3410,243.57142857142858,0
0,1,1468,65,14,22.242424242424242,1533,102.2,1
0,1,926,338,21,2.7315634218289087,1264,57.45454545454545,0
2,1,4670,284,1,16.385964912280702,4954,2477.0,1
0,0,308,900,163,0.341842397336293,1208,7.365853658536586,0
0,1,64,641,13,0.09968847352024922,705,50.357142857142854,0
0,0,32,119,19,0.26666666666666666,151,7.55,0
0,0,1240,1913,42,0.6478578892371996,3153,73.32558139534883,0
0,1,1773,719,10,2.4625,2492,226.54545454545453,0
0,1,1008,489,6,2.057142857142857,1497,213.85714285714286,0
2,0,2354,2214,4,1.0627539503386005,4568,913.6,0
0,2,1197,81,22,14.597560975609756,1278,55.56521739130435,1
1,3,463,1246,0,0.37129109863672816,1709,1709.0,0
0,3,199,362,37,0.5482093663911846,561,14.763157894736842,0
0,3,2585,950,18,2.718191377497371,3535,186.05263157894737,0
2,2,109,2135,22,0.05102996254681648,2244,97.56521739130434,0
2,0,783,583,9,1.3407534246575343,1366,136.6,0
1,1,376,18,5,19.789473684210527,394,65.66666666666667,0
1,0,316,23,36,13.166666666666666,339,9.162162162162161,1
2,0,1037,321,7,3.220496894409938,1358,169.75,1
2,1,262,1217,45,0.21510673234811165,1479,32.15217391304348,0
0,2,2481,272,6,9.087912087912088,2753,393.2857142857143,0
2,3,520,325,28,1.5950920245398772,845,29.137931034482758,0
1,3,1131,1227,30,0.9210097719869706,2358,76.06451612903226,0
0,0,1301,98,21,13.141414141414142,1399,63.59090909090909,0
1,2,1148,1500,172,0.7648234510326449,2648,15.306358381502891,0
0,3,2337,247,14,9.423387096774194,2584,172.26666666666668,0
2,2,262,42,64,6.093023255813954,304,4.676923076923077,1
1,1,89,99,5,0.89,188,31.333333333333332,0
0,0,57,2438,12,0.023370233702337023,2495,191.92307692307693,0
0,0,2102,480,4,4.37006237006237,2582,516.4,0
2,2,3622,237,27,15.218487394957982,3859,137.82142857142858,0
2,3,360,589,30,0.6101694915254238,949,30.612903225806452,0
2,2,1182,917,18,1.2875816993464053,2099,110.47368421052632,0
1,1,8,307,38,0.025974025974025976,315,8.076923076923077,0
0,3,209,1033,60,0.20212765957446807,1242,20.360655737704917,0
2,3,1168,232,44,5.012875536480687,1400,31.11111111111111,1
1,2,68,95,8,0.7083333333333334,163,18.11111111111111,0
1,1,632,638,11,0.9890453834115805,1270,105.83333333333333,0
1,3,1086,131,14,8.227272727272727,1217,81.13333333333334,0
2,0,1452,2257,6,0.6430469441984057,3709,529.8571428571429,0
2,1,604,0,13,604.0,604,43.142857142857146,0
0,3,995,1127,8,0.8820921985815603,2122,235.77777777777777,0
0,2,775,262,163,2.946768060836502,1037,6.323170731707317,0
2,3,53,1497,45,0.035380507343124167,1550,33.69565217391305,0
1,0,1357,49,58,27.14,1406,23.83050847457627,1
1,1,189,2446,76,0.07723743359215365,2635,34.22077922077922,0
1,3,32,85,32,0.37209302325581395,117,3.5454545454545454,0
0,0,599,1240,5,0.48267526188557613,1839,306.5,0
1,3,2007,582,42,3.4425385934819897,2589,60.2093023255814,1
0,3,163,450,0,0.3614190687361419,613,613.0,0
0,1,12,262,3,0.045627376425855515,274,68.5,0
1,2,116,1472,0,0.07875084860828242,1588,1588.0,0
1,2,452,178,4,2.525139664804469,630,126.0,0
2,0,867,1021,41,0.8483365949119374,1888,44.95238095238095,0
2,0,214,472,65,0.452431289640592,686,10.393939393939394,0
1,0,1619,5199,9,0.31134615384615383,6818,681.8,1
0,1,1399,756,3,1.8480845442536327,2155,538.75,0
0,2,1190,88,9,13.370786516853933,1278,127.8,0
0,0,668,435,31,1.5321100917431192,1103,34.46875,0
0,0,454,54,12,8.254545454545454,508,39.07692307692308,1
0,3,470,269,97,1.7407407407407407,739,7.540816326530612,0
2,3,699,336,4,2.0741839762611276,1035,207.0,0
1,0,80,1534,139,0.05211726384364821,1614,11.528571428571428,0
2,3,1146,1456,0,0.7865477007549759,2602,2602.0,0
0,3,433,9,18,43.3,442,23.263157894736842,1
0,3,254,607,8,0.41776315789473684,861,95.66666666666667,0
0,1,326,202,25,1.6059113300492611,528,20.307692307692307,0
0,0,198,308,3,0.6407766990291263,506,126.5,0
1,0,2318,17,62,128.77777777777777,2335,37.06349206349206,0
0,3,185,1108,4,0.16681695220919748,1293,258.6,0
1,1,2144,2406,26,0.8907353552139593,4550,168.5185185185185,0
0,3,849,198,1,4.266331658291457,1047,523.5,1
1,1,2020,334,11,6.029850746268656,2354,196.16666666666666,0
2,0,642,184,4,3.4702702702702704,826,165.2,1
0,3,2626,2127,114,1.2340225563909775,4753,41.3304347826087,0
1,0,237,7,0,29.625,244,244.0,0
2,1,808,701,13,1.150997150997151,1509,107.78571428571429,0
0,2,134,1636,10,0.08185705558949298,1770,160.9090909090909,0
0,1,592,164,32,3.587878787878788,756,22.90909090909091,1
0,2,843,713,1,1.180672268907563,1556,778.0,0
1,0,930,41,49,22.142857142857142,971,19.42,1
1,0,454,1348,18,0.3365455893254262,1802,94.84210526315789,0
2,3,79,256,18,0.30739299610894943,335,17.63157894736842,0
1,2,1065,3590,7,0.29657477025898077,4655,581.875,1
1,1,670,2040,20,0.3282704556589907,2710,129.04761904761904,0
0,0,147,1054,13,0.13933649289099526,1201,85.78571428571429,0
0,2,2746,549,8,4.992727272727273,3295,366.1111111111111,1
0,1,3116,1163,5,2.676975945017182,4279,713.1666666666666,0
0,2,1942,111,39,17.339285714285715,2053,51.325,0
0,1,1857,297,4,6.231543624161074,2154,430.8,0
0,1,103,21,5,4.681818181818182,124,20.666666666666668,0
0,1,5023,828,25,6.059107358262968,5851,225.03846153846155,0
2,1,511,1310,7,0.3897787948131198,1821,227.625,0
2,2,178,2339,18,0.07606837606837606,2517,132.47368421052633,0
2,2,1671,927,24,1.800646551724138,2598,103.92,0
2,3,255,1053,9,0.24193548387096775,1308,130.8,0
0,2,746,1806,12,0.41283895960154954,2552,196.30769230769232,0
2,2,136,2203,7,0.06170598911070781,2339,292.375,0
0,3,643,540,18,1.188539741219963,1183,62.26315789473684,0
2,2,816,93,146,8.680851063829786,909,6.183673469387755,0
1,1,590,502,13,1.1729622266401591,1092,78.0,0
2,0,72,649,31,0.11076923076923077,721,22.53125,0
2,0,663,798,30,0.8297872340425532,1461,47.12903225806452,0
0,3,632,3628,46,0.17415265913474787,4260,90.63829787234043,0
2,2,303,1996,37,0.1517275913870806,2299,60.5,0
1,2,2545,403,0,6.2995049504950495,2948,2948.0,0
0,3,540,96,11,5.56701030927835,636,53.0,0
0,0,1995,193,61,10.283505154639176,2188,35.29032258064516,0
2,1,116,152,23,0.7581699346405228,268,11.166666666666666,0
0,2,384,352,3,1.0878186968838528,736,184.0,0
0,3,193,1673,9,0.11529271206690561,1866,186.6,0
0,1,524,460,9,1.1366594360086768,984,98.4,0
0,3,118,670,61,0.17585692995529062,788,12.709677419354838,0
0,3,581,157,24,3.6772151898734178,738,29.52,1
0,3,436,543,28,0.8014705882352942,979,33.758620689655174,0
1,0,252,1654,13,0.15226586102719034,1906,136.14285714285714,0
2,0,1027,1187,1,0.8644781144781145,2214,1107.0,0
1,3,3014,67,2,44.3235294117647,3081,1027.0,0
0,2,232,1584,16,0.14637223974763408,1816,106.82352941176471,0
0,1,1244,255,5,4.859375,1499,249.83333333333334,0
2,2,1356,876,3,1.5461801596351197,2232,558.0,0
1,0,689,126,9,5.425196850393701,815,81.5,0
2,1,2279,898,40,2.5350389321468296,3177,77.48780487804878,0
1,3,3392,29,2,113.06666666666666,3421,1140.3333333333333,0
0,2,449,734,17,0.6108843537414966,1183,65.72222222222223,0
2,2,1052,830,52,1.2659446450060168,1882,35.509433962264154,0
2,3,1085,224,9,4.822222222222222,1309,130.9,0
0,2,516,2211,10,0.2332730560578662,2727,247.9090909090909,0
2,0,380,37,64,10.0,417,6.415384615384616,0
1,3,2714,1778,31,1.52557616638561,4492,140.375,0
1,2,1560,384,47,4.0519480519480515,1944,40.5,1
1,3,121,1001,10,0.12075848303393213,1122,102.0,0
1,1,127,843,172,0.1504739336492891,970,5.606936416184971,0
0,3,2558,147,4,17.283783783783782,2705,541.0,0
2,2,84,307,98,0.2727272727272727,391,3.9494949494949494,0
1,0,1166,603,69,1.9304635761589404,1769,25.271428571428572,0
0,3,257,1499,24,0.17133333333333334,1756,70.24,0
2,3,35,2478,26,0.014118596208148447,2513,93.07407407407408,0
2,2,61,16,44,3.588235294117647,77,1.711111111111111,1
0,0,467,347,10,1.3419540229885059,814,74.0,0
0,0,80,882,22,0.09060022650056625,962,41.82608695652174,0
1,1,907,600,69,1.5091514143094842,1507,21.52857142857143,0
2,1,1042,2292,2,0.45442651548190144,3334,1111.3333333333333,0
2,2,467,13,70,33.357142857142854,480,6.76056338028169,0
0,0,1358,460,39,2.945770065075922,1818,45.45,0
2,0,673,884,44,0.7604519774011299,1557,34.6,0
1,1,562,196,2,2.8527918781725887,758,252.66666666666666,0
2,1,522,1035,6,0.5038610038610039,1557,222.42857142857142,0
0,2,564,67,77,8.294117647058824,631,8.08974358974359,0
0,0,3438,479,3,7.1625,3917,979.25,0
1,3,1143,902,29,1.26578073089701,2045,68.16666666666667,0
1,1,378,248,45,1.5180722891566265,626,13.608695652173912,0
2,2,1323,61,7,21.338709677419356,1384,173.0,1
2,0,400,2517,35,0.15885623510722796,2917,81.02777777777777,0
0,0,134,1961,2,0.06829765545361875,2095,698.3333333333334,0
1,1,645,2086,20,0.3090560613320556,2731,130.04761904761904,0
1,2,1390,3071,12,0.4524739583333333,4461,343.15384615384613,1
1,3,474,163,31,2.8902439024390243,637,19.90625,0
2,1,2033,137,65,14.731884057971014,2170,32.878787878787875,0
1,2,489,27,4,17.464285714285715,516,103.2,0
0,0,430,1779,17,0.24157303370786518,2209,122.72222222222223,0
0,3,6344,1117,16,5.674418604651163,7461,438.88235294117646,0
2,2,658,802,11,0.8194271481942715,1460,121.66666666666667,0
2,3,1635,2101,19,0.7778306374881065,3736,186.8,0
1,2,1634,684,63,2.3854014598540147,2318,36.21875,0
2,2,2608,111,109,23.285714285714285,2719,24.71818181818182,1
0,2,88,155,0,0.5641025641025641,243,243.0,0
1,2,316,113,40,2.7719298245614037,429,10.463414634146341,0
0,3,1459,294,28,4.945762711864407,1753,60.44827586206897,0
1,1,826,381,156,2.162303664921466,1207,7.687898089171974,0
2,3,820,1275,2,0.6426332288401254,2095,698.3333333333334,0
1,2,181,169,50,1.0647058823529412,350,6.862745098039215,0
1,3,330,1033,81,0.3191489361702128,1363,16.621951219512194,0
0,3,736,540,72,1.3604436229205175,1276,17.47945205479452,0
0,3,324,6389,24,0.05070422535211268,6713,268.52,1
1,2,236,1198,11,0.19683069224353628,1434,119.5,0
2,3,91,2777,30,0.03275737940964723,2868,92.51612903225806,0
2,0,169,335,10,0.5029761904761905,504,45.81818181818182,0
0,2,1464,105,15,13.81132075471698,1569,98.0625,1
2,3,1268,564,17,2.2442477876106195,1832,101.77777777777777,0
0,0,46,106,10,0.42990654205607476,152,13.818181818181818,0
2,3,227,542,12,0.4180478821362799,769,59.15384615384615,0
1,1,822,251,0,3.261904761904762,1073,1073.0,0
0,3,389,540,10,0.7190388170055453,929,84.45454545454545,0
0,3,1733,2390,19,0.7248013383521539,4123,206.15,0
1,1,1537,272,5,5.6300366300366305,1809,301.5,0
0,2,2221,4020,49,0.5523501616513306,6241,124.82,1
2,1,827,208,23,3.9569377990430623,1035,43.125,0
2,2,433,186,47,2.3155080213903743,619,12.895833333333334,0
0,1,931,629,4,1.4777777777777779,1560,312.0,0
2,3,93,1476,51,0.06296547054840894,1569,30.173076923076923,0
0,3,9,1107,95,0.008122743682310469,1116,11.625,0
1,2,17,1028,13,0.01652089407191448,1045,74.64285714285714,0
0,2,523,265,10,1.9661654135338347,788,71.63636363636364,0
1,0,258,18,31,13.578947368421053,276,8.625,0
2,0,171,141,30,1.204225352112676,312,10.064516129032258,0
1,3,955,343,3,2.7761627906976742,1298,324.5,0
2,3,5317,2851,78,1.864305750350631,8168,103.39240506329114,0
0,0,195,2018,19,0.09658246656760773,2213,110.65,0
2,0,790,179,43,4.388888888888889,969,22.022727272727273,1
0,2,127,1034,13,0.12270531400966184,1161,82.92857142857143,0
0,1,2721,692,9,3.9264069264069263,3413,341.3,0
1,2,344,40,3,8.390243902439025,384,96.0,0
1,0,2106,371,9,5.661290322580645,2477,247.7,1
1,3,332,532,150,0.6228893058161351,864,5.7218543046357615,0
1,0,1640,881,32,1.8594104308390023,2521,76.39393939393939,0
2,3,234,279,48,0.8357142857142857,513,10.46938775510204,0
2,3,346,2172,95,0.1592268752876208,2518,26.229166666666668,0
2,3,213,481,2,0.44190871369294604,694,231.33333333333334,0
0,3,306,228,5,1.3362445414847162,534,89.0,0
2,1,1800,304,78,5.901639344262295,2104,26.632911392405063,0
2,0,1018,1115,24,0.9121863799283154,2133,85.32,0
2,2,520,817,30,0.6356968215158925,1337,43.12903225806452,0
1,3,3558,1084,16,3.27926267281106,4642,273.05882352941177,0
2,3,625,276,50,2.256317689530686,901,17.666666666666668,0
0,2,3498,316,21,11.034700315457414,3814,173.36363636363637,0
1,2,218,404,52,0.5382716049382716,622,11.735849056603774,0
0,3,2350,167,145,13.988095238095237,2517,17.23972602739726,0
2,2,13,939,31,0.013829787234042552,952,29.75,0
1,2,788,319,22,2.4625,1107,48.130434782608695,0
0,1,550,315,13,1.740506329113924,865,61.785714285714285,0
2,2,744,251,6,2.9523809523809526,995,142.14285714285714,0
0,0,806,482,32,1.6687370600414078,1288,39.03030303030303,0
0,0,492,1182,1,0.4158918005071851,1674,837.0,0
0,0,6318,1444,93,4.372318339100346,7762,82.57446808510639,0
2,3,3751,1305,31,2.8721286370597245,5056,158.0,0
2,0,3263,776,96,4.199485199485199,4039,41.63917525773196,0
0,1,3867,263,9,14.647727272727273,4130,413.0,0
1,0,1575,1061,87,1.4830508474576272,2636,29.954545454545453,0
1,3,4473,32,28,135.54545454545453,4505,155.3448275862069,1
2,1,2228,1280,49,1.7392661982825917,3508,70.16,0
2,0,537,1212,5,0.4427040395713108,1749,291.5,0
2,1,1536,886,20,1.7316798196166854,2422,115.33333333333333,0
2,1,2431,82,25,29.289156626506024,2513,96.65384615384616,1
2,3,1246,4743,14,0.2626475548060708,5989,399.26666666666665,1
1,3,549,1129,8,0.48584070796460177,1678,186.44444444444446,0
2,1,68,1061,70,0.064030131826742,1129,15.901408450704226,0
0,0,1659,52,2,31.30188679245283,1711,570.3333333333334,0
0,3,3052,406,5,7.498771498771498,3458,576.3333333333334,0
1,1,450,72,11,6.164383561643835,522,43.5,0
0,2,164,358,75,0.4568245125348189,522,6.868421052631579,0
1,2,395,676,24,0.5834564254062038,1071,42.84,0
1,3,873,1688,14,0.5168738898756661,2561,170.73333333333332,0
0,0,381,266,15,1.4269662921348314,647,40.4375,0
2,2,943,781,54,1.2058823529411764,1724,31.345454545454544,0
0,2,3406,143,0,23.65277777777778,3549,3549.0,1
0,2,1110,349,0,3.1714285714285713,1459,1459.0,0
1,0,450,2353,1,0.1911639762107052,2803,1401.5,0
0,0,2745,1101,19,2.4909255898366607,3846,192.3,0
1,3,833,631,26,1.3180379746835442,1464,54.22222222222222,0
2,3,137,231,29,0.5905172413793104,368,12.266666666666667,0
2,2,691,382,39,1.804177545691906,1073,26.825,0
2,0,1060,136,6,7.737226277372263,1196,170.85714285714286,1
0,1,1821,348,9,5.217765042979942,2169,216.9,1
1,2,2756,130,8,21.0381679389313,2886,320.6666666666667,0
2,3,381,1268,4,0.30023640661938533,1649,329.8,0
1,0,169,67,8,2.485294117647059,236,26.22222222222222,0
1,3,76,167,28,0.4523809523809524,243,8.379310344827585,0
2,3,1340,939,13,1.425531914893617,2279,162.78571428571428,0
2,0,1585,1862,43,0.8507783145464305,3447,78.3409090909091,0
1,2,526,2672,23,0.19678264122708566,3198,133.25,0
2,0,504,1446,7,0.3483068417415342,1950,243.75,0
1,2,3084,190,18,16.146596858638745,3274,172.31578947368422,0
1,3,2485,269,26,9.203703703703704,2754,102.0,0
2,0,265,1636,60,0.16188149053145998,1901,31.16393442622951,0
0,1,1517,1760,53,0.861442362294151,3277,60.68518518518518,0
2,2,974,818,16,1.1892551892551892,1792,105.41176470588235,0
0,1,167,301,31,0.5529801324503312,468,14.625,0
1,2,441,202,10,2.1724137931034484,643,58.45454545454545,0
1,0,195,1529,30,0.12745098039215685,1724,55.61290322580645,0
0,1,349,183,73,1.8967391304347827,532,7.1891891891891895,0
1,0,955,867,29,1.1002304147465438,1822,60.733333333333334,0
0,2,470,2752,10,0.17072284780239738,3222,292.90909090909093,0
0,2,500,977,30,0.5112474437627812,1477,47.645161290322584,0
1,2,775,238,69,3.2426778242677825,1013,14.471428571428572,0
0,2,91,265,4,0.34210526315789475,356,71.2,0
2,3,1342,77,19,17.205128205128204,1419,70.95,1
2,2,513,927,11,0.552801724137931,1440,120.0,0
1,1,654,584,8,1.117948717948718,1238,137.55555555555554,0
1,2,3661,185,15,19.682795698924732,3846,240.375,1
0,0,422,206,15,2.0386473429951693,628,39.25,0
0,3,1044,7,7,130.5,1051,131.375,0
0,1,498,3068,15,0.16226783968719452,3566,222.875,0
0,3,2246,1408,30,1.5940383250532293,3654,117.87096774193549,0
2,3,1875,400,0,4.675810473815462,2275,2275.0,0
2,3,276,2336,135,0.11810012836970475,2612,19.205882352941178,0
1,0,1176,904,10,1.2994475138121546,2080,189.0909090909091,0
0,3,67,1113,29,0.06014362657091562,1180,39.333333333333336,0
0,3,3301,911,10,3.619517543859649,4212,382.90909090909093,0
1,2,429,1131,15,0.3789752650176678,1560,97.5,0
0,0,1782,149,23,11.88,1931,80.45833333333333,0
0,1,383,661,28,0.5785498489425982,1044,36.0,0
0,1,1001,1514,44,0.6607260726072607,2515,55.888888888888886,0
0,1,4109,15,47,256.8125,4124,85.91666666666667,0
0,0,2093,105,21,19.745283018867923,2198,99.9090909090909,0
1,1,174,225,2,0.7699115044247787,399,133.0,0
0,0,792,279,24,2.8285714285714287,1071,42.84,0
1,2,428,161,19,2.6419753086419755,589,29.45,0
0,2,569,783,7,0.7257653061224489,1352,169.0,0
2,0,408,278,0,1.4623655913978495,686,686.0,0
2,1,409,137,11,2.963768115942029,546,45.5,0
2,0,782,1890,9,0.41353781068217876,2672,267.2,0
2,0,213,950,19,0.22397476340694006,1163,58.15,0
1,3,770,225,43,3.4070796460176993,995,22.613636363636363,0
1,0,327,358,17,0.9108635097493036,685,38.05555555555556,0
0,3,341,1080,90,0.3154486586493987,1421,15.615384615384615,0
2,2,1342,1251,7,1.071884984025559,2593,324.125,0
1,3,30,155,7,0.19230769230769232,185,23.125,0
0,0,479,2206,27,0.21703670140462167,2685,95.89285714285714,0
0,2,523,1230,67,0.4248578391551584,1753,25.779411764705884,0
1,3,663,1554,33,0.42636655948553054,2217,65.20588235294117,0
2,0,1105,124,33,8.84,1229,36.14705882352941,1
0,2,461,123,49,3.717741935483871,584,11.68,0
2,3,239,291,33,0.8184931506849316,530,15.588235294117647,0
2,0,2161,53,42,40.01851851851852,2214,51.48837209302326,0
2,0,3965,76,60,51.493506493506494,4041,66.24590163934427,1
0,1,20,123,0,0.16129032258064516,143,143.0,0
2,1,790,997,65,0.7915831663326653,1787,27.075757575757574,0
0,3,418,24,7,16.72,442,55.25,0
2,3,324,69,72,4.628571428571429,393,5.383561643835616,0
0,3,409,2308,9,0.17713295799047207,2717,271.7,0
2,0,1018,69,18,14.542857142857143,1087,57.21052631578947,1
1,3,211,616,81,0.3419773095623987,827,10.085365853658537,0
2,0,2440,823,3,2.9611650485436893,3263,815.75,0
2,3,627,2547,41,0.24607535321821036,3174,75.57142857142857,0
0,0,393,1840,14,0.21347093970668116,2233,148.86666666666667,0
0,0,1450,464,0,3.118279569892473,1914,1914.0,0
2,1,16,2280,83,0.0070144673388864535,2296,27.333333333333332,0
1,2,565,452,3,1.2472406181015452,1017,254.25,0
1,0,438,886,44,0.49379932356257045,1324,29.42222222222222,0
0,3,412,240,14,1.7095435684647302,652,43.46666666666667,0
1,1,411,809,49,0.5074074074074074,1220,24.4,0
2,3,31,618,41,0.050080775444264945,649,15.452380952380953,0
0,3,165,746,30,0.22088353413654618,911,29.387096774193548,0
2,0,153,918,84,0.16648531011969533,1071,12.6,0
0,0,4475,152,3,29.248366013071895,4627,1156.75,1
0,2,22,286,48,0.07665505226480836,308,6.285714285714286,0
0,0,182,1066,33,0.17057169634489222,1248,36.705882352941174,0
0,0,3656,143,11,25.38888888888889,3799,316.5833333333333,1
1,2,989,337,23,2.92603550295858,1326,55.25,0
2,3,599,878,31,0.6814562002275313,1477,46.15625,0
2,2,82,2220,39,0.03692030616839262,2302,57.55,0
2,2,1107,62,6,17.571428571428573,1169,167.0,0
0,2,148,581,3,0.2542955326460481,729,182.25,0
1,1,1112,68,3,16.115942028985508,1180,295.0,0
2,3,3871,381,10,10.133507853403142,4252,386.54545454545456,0
1,1,759,154,5,4.896774193548387,913,152.16666666666666,0
0,1,240,838,23,0.2860548271752086,1078,44.916666666666664,0
2,0,981,1134,17,0.8643171806167401,2115,117.5,0
1,2,719,227,67,3.1535087719298245,946,13.911764705882353,0
0,2,761,998,37,0.7617617617617618,1759,46.28947368421053,0
1,1,650,473,6,1.371308016877637,1123,160.42857142857142,0
2,0,1120,266,1,4.194756554307116,1386,693.0,0
2,0,848,592,37,1.430016863406408,1440,37.89473684210526,0
0,0,4342,381,56,11.366492146596858,4723,82.85964912280701,1
0,3,1747,209,36,8.31904761904762,1956,52.86486486486486,1
0,1,307,1131,30,0.2712014134275618,1438,46.38709677419355,0
1,3,1293,1277,8,1.011737089201878,2570,285.55555555555554,0
1,0,241,1288,20,0.186966640806827,1529,72.80952380952381,0
1,0,1524,385,38,3.948186528497409,1909,48.94871794871795,0
0,0,159,148,6,1.0671140939597314,307,43.857142857142854,0
2,2,641,1468,19,0.43635125936010893,2109,105.45,0
2,1,1563,319,3,4.884375,1882,470.5,0
1,2,328,1102,22,0.2973708068902992,1430,62.17391304347826,0
1,3,1814,1360,25,1.3328434974283614,3174,122.07692307692308,0
2,2,1033,1169,22,0.8829059829059829,2202,95.73913043478261,0
2,1,506,395,19,1.2777777777777777,901,45.05,0
1,2,550,2224,26,0.24719101123595505,2774,102.74074074074075,0
1,0,2603,863,172,3.0127314814814814,3466,20.034682080924856,0
2,3,245,685,29,0.35714285714285715,930,31.0,0
0,3,1182,957,41,1.2338204592901878,2139,50.92857142857143,0
1,0,1228,36,6,33.189189189189186,1264,180.57142857142858,0
2,0,2556,396,22,6.438287153652393,2952,128.34782608695653,0
2,0,1248,1704,0,0.7319648093841642,2952,2952.0,0
2,1,878,140,0,6.226950354609929,1018,1018.0,0
2,2,2328,428,11,5.426573426573427,2756,229.66666666666666,1
0,3,1766,415,18,4.2451923076923075,2181,114.78947368421052,1
2,2,1261,352,25,3.5722379603399435,1613,62.03846153846154,0
1,0,33,661,65,0.04984894259818731,694,10.515151515151516,0
0,0,467,4457,44,0.1047554957379991,4924,109.42222222222222,1
2,2,999,236,10,4.215189873417722,1235,112.27272727272727,0
0,3,738,976,40,0.7553735926305015,1714,41.80487804878049,0
1,1,384,1135,23,0.3380281690140845,1519,63.291666666666664,0
2,2,155,702,45,0.22048364153627312,857,18.630434782608695,0
1,0,805,82,15,9.698795180722891,887,55.4375,0
2,0,336,679,2,0.49411764705882355,1015,338.3333333333333,0
2,1,265,2454,28,0.1079429735234216,2719,93.75862068965517,0
2,2,509,334,24,1.519402985074627,843,33.72,0
2,1,1539,816,92,1.8837209302325582,2355,25.322580645161292,0
2,1,669,2563,5,0.2609204368174727,3232,538.6666666666666,0
0,3,243,1279,32,0.18984375,1522,46.121212121212125,0
2,3,124,932,19,0.13290460878885316,1056,52.8,0
2,0,691,2836,14,0.24356714839619317,3527,235.13333333333333,0
0,2,1581,149,47,10.54,1730,36.041666666666664,1
0,3,1057,1185,49,0.8912310286677909,2242,44.84,0
0,0,264,417,37,0.631578947368421,681,17.92105263157895,0
0,2,573,357,2,1.600558659217877,930,310.0,0
0,0,1932,588,12,3.2801358234295415,2520,193.84615384615384,0
0,3,195,27,1,6.964285714285714,222,111.0,1
2,0,759,299,12,2.53,1058,81.38461538461539,0
2,2,440,145,31,3.0136986301369864,585,18.28125,1
1,2,132,119,21,1.1,251,11.409090909090908,0
2,0,51,329,36,0.15454545454545454,380,10.27027027027027,0
2,2,811,1296,24,0.6252891287586738,2107,84.28,0
0,0,20,179,24,0.1111111111111111,199,7.96,0
0,2,109,606,21,0.17957166392092258,715,32.5,0
2,0,427,1104,13,0.38642533936651585,1531,109.35714285714286,0
1,0,44,220,17,0.19909502262443438,264,14.666666666666666,0
0,0,511,2063,3,0.24757751937984496,2574,643.5,0
2,1,139,1610,53,0.08628181253879579,1749,32.388888888888886,0
2,2,430,231,66,1.853448275862069,661,9.865671641791044,0
1,3,1566,3655,43,0.42833698030634576,5221,118.6590909090909,1
1,0,984,884,26,1.111864406779661,1868,69.18518518518519,0
0,1,589,269,25,2.1814814814814816,858,33.0,0
1,3,96,914,19,0.10491803278688525,1010,50.5,0
2,0,965,877,7,1.0990888382687927,1842,230.25,0
2,3,178,745,14,0.2386058981233244,923,61.53333333333333,0
1,1,79,994,137,0.07939698492462312,1073,7.77536231884058,0
1,3,1090,249,4,4.36,1339,267.8,0
1,0,2431,3090,23,0.7864768683274022,5521,230.04166666666666,1
1,3,617,1560,60,0.39525944907110827,2177,35.68852459016394,0
0,3,41,1095,18,0.037408759124087594,1136,59.78947368421053,0
1,0,2122,21,27,96.45454545454545,2143,76.53571428571429,0
0,1,69,714,52,0.0965034965034965,783,14.773584905660377,0
2,1,2021,980,23,2.0601427115188584,3001,125.04166666666667,0
1,3,497,1539,39,0.32272727272727275,2036,50.9,0
0,2,454,2337,12,0.1941830624465355,2791,214.69230769230768,0
1,3,782,1980,39,0.39475012619888944,2762,69.05,0
2,2,3148,416,1,7.54916067146283,3564,1782.0,0
2,3,2290,1814,4,1.2617079889807163,4104,820.8,0
2,1,635,0,30,635.0,635,20.483870967741936,0
1,3,1190,346,17,3.4293948126801155,1536,85.33333333333333,0
1,3,868,96,52,8.948453608247423,964,18.18867924528302,0
0,2,1182,1716,12,0.6884100174723354,2898,222.92307692307693,0
2,1,1768,2104,43,0.8399049881235154,3872,88.0,0
1,2,35,236,4,0.14767932489451477,271,54.2,0
2,3,394,366,79,1.0735694822888284,760,9.5,0
2,0,3202,3302,16,0.9694217378141083,6504,382.5882352941176,1
0,3,2982,667,7,4.4640718562874255,3649,456.125,0
0,3,11,549,46,0.02,560,11.914893617021276,0
0,2,224,555,88,0.4028776978417266,779,8.752808988764045,0
0,0,5078,953,75,5.322851153039832,6031,79.35526315789474,1
2,0,678,2472,8,0.2741609381318237,3150,350.0,0
0,2,850,365,33,2.3224043715846996,1215,35.73529411764706,0
0,1,182,151,23,1.1973684210526316,333,13.875,0
0,0,2247,163,38,13.701219512195122,2410,61.794871794871796,1
0,0,263,16,20,15.470588235294118,279,13.285714285714286,1
2,2,210,648,19,0.3235747303543914,858,42.9,0
0,1,258,2117,64,0.12181303116147309,2375,36.53846153846154,0
2,1,2521,998,61,2.5235235235235236,3519,56.75806451612903,0
1,3,1213,3965,46,0.3058497226424609,5178,110.17021276595744,0
2,3,1463,1922,36,0.7607904316172647,3385,91.48648648648648,0
2,2,473,541,34,0.8726937269372693,1014,28.97142857142857,0
0,1,2398,533,1,4.49063670411985,2931,1465.5,1
1,2,1557,791,41,1.9659090909090908,2348,55.904761904761905,0
1,3,1388,94,30,14.610526315789473,1482,47.806451612903224,0
1,2,3538,748,10,4.7236315086782374,4286,389.6363636363636,1
1,2,456,499,51,0.912,955,18.365384615384617,0
2,0,944,823,53,1.145631067961165,1767,32.72222222222222,0
1,0,2407,666,80,3.608695652173913,3073,37.93827160493827,1
2,0,1564,297,16,5.248322147651007,1861,109.47058823529412,0
2,3,828,748,24,1.1054739652870493,1576,63.04,0
2,2,79,364,70,0.21643835616438356,443,6.23943661971831,0
1,0,1057,173,11,6.074712643678161,1230,102.5,0
0,0,747,899,47,0.83,1646,34.291666666666664,0
0,0,203,292,144,0.6928327645051194,495,3.413793103448276,0
1,3,2139,1758,31,1.2160318362706084,3897,121.78125,0
0,3,420,177,123,2.359550561797753,597,4.814516129032258,0
0,2,490,733,21,0.667574931880109,1223,55.59090909090909,0
2,2,1115,678,4,1.642120765832106,1793,358.6,0
2,2,670,176,5,3.785310734463277,846,141.0,1
1,0,93,463,39,0.20043103448275862,556,13.9,0
1,1,490,900,0,0.5438401775804661,1390,1390.0,0
0,3,99,306,32,0.32247557003257327,405,12.272727272727273,0
2,0,211,96,4,2.1752577319587627,307,61.4,0
1,0,7,764,124,0.009150326797385621,771,6.168,0
1,2,200,203,5,0.9803921568627451,403,67.16666666666667,0
1,2,401,915,24,0.43777292576419213,1316,52.64,0
1,0,772,1463,33,0.5273224043715847,2235,65.73529411764706,0
1,3,2516,105,51,23.735849056603772,2621,50.40384615384615,1
1,3,777,460,18,1.685466377440347,1237,65.10526315789474,0
0,0,1222,470,81,2.59447983014862,1692,20.634146341463413,0
2,1,442,800,19,0.5518102372034956,1242,62.1,0
2,1,1392,325,8,4.269938650306749,1717,190.77777777777777,1
1,3,968,433,26,2.230414746543779,1401,51.888888888888886,0
2,2,615,9,32,61.5,624,18.90909090909091,1
2,1,215,104,21,2.0476190476190474,319,14.5,0
2,1,361,674,39,0.5348148148148149,1035,25.875,0
1,2,970,194,16,4.9743589743589745,1164,68.47058823529412,1
1,1,555,124,0,4.44,679,679.0,0
2,0,2201,313,9,7.009554140127388,2514,251.4,0
2,1,267,142,87,1.867132867132867,409,4.6477272727272725,0
1,2,75,49,43,1.5,124,2.8181818181818183,0
0,0,890,267,6,3.3208955223880596,1157,165.28571428571428,0
2,1,2172,143,2,15.083333333333334,2315,771.6666666666666,0
0,3,453,1285,12,0.3522550544323484,1738,133.69230769230768,0
2,0,1043,51,54,20.057692307692307,1094,19.89090909090909,0
0,0,263,1100,3,0.23887375113533152,1363,340.75,0
0,3,817,386,23,2.111111111111111,1203,50.125,0
0,3,1545,899,9,1.7166666666666666,2444,244.4,0
1,1,2017,43,38,45.84090909090909,2060,52.82051282051282,1
0,1,111,2027,0,0.05473372781065089,2138,2138.0,0
0,2,440,1166,9,0.37703513281919454,1606,160.6,0
0,2,1020,120,34,8.429752066115702,1140,32.57142857142857,1
2,0,35,197,23,0.17676767676767677,232,9.666666666666666,0
0,3,1173,826,45,1.4183796856106408,1999,43.45652173913044,0
2,3,750,2036,5,0.36818851251840945,2786,464.3333333333333,0
0,2,340,472,22,0.718816067653277,812,35.30434782608695,0
0,0,1685,531,6,3.167293233082707,2216,316.57142857142856,0
1,0,342,217,30,1.5688073394495412,559,18.032258064516128,0
2,2,4757,386,4,12.291989664082687,5143,1028.6,0
0,2,1694,269,4,6.274074074074074,1963,392.6,0
2,2,1230,345,11,3.554913294797688,1575,131.25,0
2,1,63,16,15,3.7058823529411766,79,4.9375,1
1,0,2346,33,20,69.0,2379,113.28571428571429,0
1,0,1560,913,26,1.7067833698030634,2473,91.5925925925926,0
1,0,260,916,18,0.2835332606324973,1176,61.89473684210526,0
1,2,497,320,1,1.5482866043613708,817,408.5,0
1,2,312,1733,12,0.17993079584775087,2045,157.30769230769232,0
1,2,4161,247,1,16.778225806451612,4408,2204.0,1
1,2,1925,403,3,4.764851485148514,2328,582.0,0
1,3,2662,1051,2,2.53041825095057,3713,1237.6666666666667,0
0,2,1554,1088,5,1.4269972451790633,2642,440.3333333333333,0
2,1,609,1579,50,0.38544303797468354,2188,42.90196078431372,0
1,3,229,23,29,9.541666666666666,252,8.4,0
1,3,233,162,21,1.4294478527607362,395,17.954545454545453,0
2,2,164,818,39,0.20024420024420025,982,24.55,0
0,0,791,330,97,2.389728096676737,1121,11.438775510204081,0
2,2,2525,35,16,70.13888888888889,2560,150.58823529411765,0
2,0,4803,706,13,6.793493635077794,5509,393.5,1
1,2,338,399,114,0.845,737,6.408695652173913,0
2,2,1195,362,44,3.2920110192837466,1557,34.6,1
2,0,909,245,45,3.6951219512195124,1154,25.08695652173913,0
1,0,671,4,27,134.2,675,24.107142857142858,0
1,0,1095,161,21,6.7592592592592595,1256,57.09090909090909,1
1,0,464,514,23,0.9009708737864077,978,40.75,0
1,1,2891,258,31,11.162162162162161,3149,98.40625,0
2,0,1222,1659,14,0.736144578313253,2881,192.06666666666666,0
2,2,1403,123,45,11.314516129032258,1526,33.17391304347826,1
0,2,277,1665,71,0.16626650660264106,1942,26.97222222222222,0
0,1,184,415,25,0.4423076923076923,599,23.03846153846154,0
2,0,501,258,14,1.9343629343629343,759,50.6,0
0,2,1455,290,35,5.0,1745,48.47222222222222,1
2,1,2793,320,6,8.700934579439252,3113,444.7142857142857,0
0,2,557,565,103,0.9840989399293286,1122,10.788461538461538,0
1,1,1487,349,32,4.248571428571428,1836,55.63636363636363,1
0,1,635,833,2,0.7613908872901679,1468,489.3333333333333,0
1,3,349,442,22,0.7878103837471784,791,34.391304347826086,0
1,3,1344,890,41,1.5084175084175084,2234,53.19047619047619,0
1,0,1600,741,9,2.1563342318059298,2341,234.1,0
1,3,226,224,1,1.0044444444444445,450,225.0,0
0,1,364,1340,20,0.2714392244593587,1704,81.14285714285714,0
2,2,682,1283,53,0.5311526479750779,1965,36.388888888888886,0
1,2,206,3606,8,0.057111172719711674,3812,423.55555555555554,0
0,0,2642,153,37,17.155844155844157,2795,73.55263157894737,1
1,3,894,1506,15,0.5932315859323158,2400,150.0,0
0,0,129,1644,1,0.07841945288753799,1773,886.5,0
0,1,203,822,10,0.24665856622114216,1025,93.18181818181819,0
0,3,3086,564,11,5.4619469026548675,3650,304.1666666666667,0
2,0,1340,2522,70,0.5311137534680935,3862,54.394366197183096,0
0,2,1325,2880,120,0.45990975355779246,4205,34.752066115702476,0
0,2,75,821,7,0.09124087591240876,896,112.0,0
2,0,2256,356,16,6.319327731092437,2612,153.64705882352942,0
2,0,586,1359,112,0.4308823529411765,1945,17.212389380530972,0
0,0,1077,74,15,14.36,1151,71.9375,0
2,1,3211,274,12,11.676363636363636,3485,268.0769230769231,0
1,1,105,3389,3,0.030973451327433628,3494,873.5,0
1,2,658,1347,41,0.48813056379821956,2005,47.73809523809524,0
2,1,50,2245,17,0.02226179875333927,2295,127.5,0
2,1,692,722,30,0.9571230982019364,1414,45.61290322580645,0
0,3,290,418,21,0.6921241050119332,708,32.18181818181818,0
2,1,2419,3117,5,0.7758178319435536,5536,922.6666666666666,0
0,3,508,296,5,1.7104377104377104,804,134.0,0
1,1,1004,1133,84,0.8853615520282186,2137,25.141176470588235,0
2,2,1968,653,66,3.0091743119266057,2621,39.11940298507463,0
0,0,4116,207,28,19.78846153846154,4323,149.06896551724137,1
0,2,700,14,0,46.666666666666664,714,714.0,0
1,1,608,387,17,1.5670103092783505,995,55.27777777777778,0
2,0,78,634,22,0.12283464566929134,712,30.956521739130434,0
1,0,12,161,17,0.07407407407407407,173,9.61111111111111,0
0,0,938,428,77,2.1864801864801864,1366,17.512820512820515,0
0,3,67,764,1,0.08758169934640522,831,415.5,0
2,2,478,1003,31,0.4760956175298805,1481,46.28125,0
0,3,3,43,11,0.06818181818181818,46,3.8333333333333335,0
2,0,955,872,24,1.0939289805269188,1827,73.08,0
1,2,554,46,32,11.787234042553191,600,18.181818181818183,0
2,2,135,22,17,5.869565217391305,157,8.722222222222221,1
2,1,351,132,4,2.6390977443609023,483,96.6,0
0,3,843,848,21,0.9929328621908127,1691,76.86363636363636,0
0,3,1069,43,81,24.295454545454547,1112,13.560975609756097,0
2,1,620,16,23,36.470588235294116,636,26.5,1
0,3,1629,100,3,16.128712871287128,1729,432.25,0
0,0,119,2392,52,0.04972837442540744,2511,47.37735849056604,0
0,0,88,1902,7,0.046242774566473986,1990,248.75,0
2,3,45,72,13,0.6164383561643836,117,8.357142857142858,0
0,1,767,289,16,2.6448275862068966,1056,62.11764705882353,0
2,2,1224,2354,12,0.5197452229299363,3578,275.2307692307692,0
0,3,139,82,15,1.6746987951807228,221,13.8125,0
1,2,1018,79,47,12.725,1097,22.854166666666668,0
0,1,648,71,7,9.0,719,89.875,1
0,2,4369,2999,19,1.4563333333333333,7368,368.4,0
2,1,1263,1087,0,1.1608455882352942,2350,2350.0,0
2,1,1071,193,21,5.520618556701031,1264,57.45454545454545,0
0,0,845,37,3,22.236842105263158,882,220.5,1
1,0,5939,2687,9,2.2094494047619047,8626,862.6,0
0,1,3935,443,11,8.862612612612613,4378,364.8333333333333,0
0,3,772,729,2,1.0575342465753426,1501,500.3333333333333,0
1,0,607,261,13,2.316793893129771,868,62.0,0
2,1,620,1136,20,0.5452946350043976,1756,83.61904761904762,0
0,2,559,175,16,3.1761363636363638,734,43.1764705882353,1
2,2,758,1236,9,0.6127728375101051,1994,199.4,0
2,3,319,209,10,1.519047619047619,528,48.0,0
1,2,2614,82,30,31.49397590361446,2696,86.96774193548387,1
1,2,673,521,38,1.289272030651341,1194,30.615384615384617,0
2,1,1845,1342,25,1.373790022338049,3187,122.57692307692308,0
0,2,644,388,112,1.6555269922879177,1032,9.132743362831858,0
2,2,1266,23,86,52.75,1289,14.816091954022989,0
0,2,410,644,3,0.6356589147286822,1054,263.5,0
0,2,980,912,9,1.0733844468784228,1892,189.2,0
1,1,689,1079,60,0.637962962962963,1768,28.983606557377048,0
0,2,457,411,0,1.1092233009708738,868,868.0,0
0,3,2133,81,26,26.01219512195122,2214,82.0,0
2,0,119,702,92,0.16927453769559034,821,8.827956989247312,0
1,3,667,319,34,2.084375,986,28.17142857142857,0
0,0,216,2348,2,0.09195402298850575,2564,854.6666666666666,0
0,3,1973,558,41,3.5295169946332736,2531,60.26190476190476,0
1,0,292,511,14,0.5703125,803,53.53333333333333,0
2,0,1003,295,76,3.3885135135135136,1298,16.857142857142858,0
1,0,180,330,10,0.5438066465256798,510,46.36363636363637,0
1,0,519,575,19,0.9010416666666666,1094,54.7,0
0,1,2296,292,41,7.836177474402731,2588,61.61904761904762,0
0,3,181,1782,8,0.10151430173864273,1963,218.11111111111111,0
2,0,1088,462,6,2.349892008639309,1550,221.42857142857142,0
0,3,228,276,0,0.8231046931407943,504,504.0,0
0,2,537,135,20,3.948529411764706,672,32.0,1
1,0,777,892,79,0.8701007838745801,1669,20.8625,0
0,3,861,20,9,41.0,881,88.1,0
2,1,922,478,1,1.9248434237995824,1400,700.0,0
1,3,1022,639,29,1.596875,1661,55.36666666666667,0
2,0,317,332,1,0.9519519519519519,649,324.5,0
1,2,513,1108,21,0.4625788999098287,1621,73.68181818181819,0
0,3,38,900,14,0.042175360710321866,938,62.53333333333333,0
1,2,1464,2843,19,0.5147679324894515,4307,215.35,0
1,1,1814,568,5,3.18804920913884,2382,397.0,0
0,3,222,617,2,0.3592233009708738,839,279.6666666666667,0
0,3,224,225,41,0.9911504424778761,449,10.69047619047619,0
2,1,42,389,8,0.1076923076923077,431,47.888888888888886,0
2,1,3519,21,48,159.95454545454547,3540,72.24489795918367,0
0,1,1646,935,42,1.7585470085470085,2581,60.02325581395349,0
0,0,447,298,6,1.4949832775919731,745,106.42857142857143,0
0,0,657,621,71,1.0562700964630225,1278,17.75,0
1,3,345,235,5,1.4618644067796611,580,96.66666666666667,0
1,3,909,776,47,1.16988416988417,1685,35.104166666666664,0
1,3,1263,474,16,2.6589473684210527,1737,102.17647058823529,0
0,2,593,526,6,1.125237191650854,1119,159.85714285714286,0
2,1,2068,2286,83,0.9042413642326191,4354,51.833333333333336,0
0,3,727,979,99,0.7418367346938776,1706,17.06,0
1,1,155,242,21,0.6378600823045267,397,18.045454545454547,0
1,0,973,560,18,1.7344028520499108,1533,80.6842105263158,0
0,1,620,502,69,1.2326043737574552,1122,16.02857142857143,0
0,2,2743,1268,27,2.161544523246651,4011,143.25,0
1,2,497,1433,9,0.34658298465829845,1930,193.0,0
1,1,515,266,16,1.9288389513108615,781,45.94117647058823,0
1,2,1052,1376,54,0.7639796659404503,2428,44.14545454545455,0
0,2,748,158,58,4.70440251572327,906,15.35593220338983,0
1,0,469,1150,84,0.40747176368375326,1619,19.04705882352941,0
1,3,4582,228,10,20.00873362445415,4810,437.27272727272725,0
2,2,359,282,34,1.2685512367491165,641,18.314285714285713,0
0,3,325,1530,2,0.2122795558458524,1855,618.3333333333334,0
2,1,1998,435,38,4.58256880733945,2433,62.38461538461539,0
2,1,3,3730,24,0.0008040739748056821,3733,149.32,0
1,2,224,131,8,1.696969696969697,355,39.44444444444444,0
0,1,892,497,31,1.7911646586345382,1389,43.40625,0
1,0,177,1054,4,0.16777251184834124,1231,246.2,0
0,2,4254,4,12,850.8,4258,327.53846153846155,1
2,2,623,131,15,4.71969696969697,754,47.125,0
0,2,909,16,45,53.470588235294116,925,20.108695652173914,0
1,1,174,3955,11,0.04398382204246714,4129,344.0833333333333,0
1,1,341,1143,1,0.2980769230769231,1484,742.0,0
1,2,953,374,5,2.541333333333333,1327,221.16666666666666,0
0,3,797,135,28,5.860294117647059,932,32.13793103448276,0
2,1,1534,75,0,20.18421052631579,1609,1609.0,1
2,1,313,607,47,0.5148026315789473,920,19.166666666666668,0
0,2,1059,2980,69,0.355249916135525,4039,57.7,0
1,3,343,898,20,0.38153503893214685,1241,59.095238095238095,0
2,2,883,363,36,2.4258241758241756,1246,33.67567567567568,0
1,1,928,555,18,1.669064748201439,1483,78.05263157894737,0
0,2,129,5452,11,0.02365670273244086,5581,465.0833333333333,0
1,2,795,585,5,1.3566552901023892,1380,230.0,0
2,2,12,2663,21,0.0045045045045045045,2675,121.5909090909091,0
2,3,695,13,79,49.642857142857146,708,8.85,0
1,2,1195,1021,66,1.1692759295499022,2216,33.07462686567164,0
0,1,75,789,75,0.0949367088607595,864,11.368421052631579,0
1,2,2792,924,101,3.018378378378378,3716,36.431372549019606,0
0,3,613,676,5,0.9054652880354506,1289,214.83333333333334,0
1,0,2787,36,4,75.32432432432432,2823,564.6,0
2,3,113,129,16,0.8692307692307693,242,14.235294117647058,0
0,2,2993,2043,35,1.4642857142857142,5036,139.88888888888889,0
0,0,115,212,17,0.539906103286385,327,18.166666666666668,0
0,2,618,3962,66,0.15594246782740348,4580,68.35820895522389,1
2,3,2780,910,37,3.0515916575192095,3690,97.10526315789474,0
1,0,264,470,30,0.5605095541401274,734,23.677419354838708,0
2,0,35,2021,2,0.01730959446092977,2056,685.3333333333334,0
0,2,1575,1267,5,1.2421135646687698,2842,473.6666666666667,0
1,2,906,448,16,2.0178173719376393,1354,79.6470588235294,0
2,3,721,56,112,12.649122807017545,777,6.876106194690266,0
0,2,34,1621,12,0.02096177558569667,1655,127.3076923076923,0
0,0,1059,1158,29,0.913718723037101,2217,73.9,0
2,1,188,1251,135,0.1501597444089457,1439,10.580882352941176,0
2,1,2676,1092,9,2.4483074107959744,3768,376.8,0
2,3,1157,258,5,4.467181467181467,1415,235.83333333333334,1
0,2,1227,1566,23,0.7830248883216337,2793,116.375,0
2,3,264,1,24,132.0,265,10.6,1
0,1,2126,216,76,9.797235023041475,2342,30.415584415584416,0
2,1,771,38,0,19.76923076923077,809,809.0,0
0,2,1945,93,15,20.69148936170213,2038,127.375,0
0,0,316,608,11,0.5188834154351396,924,77.0,0
1,2,1408,30,25,45.41935483870968,1438,55.30769230769231,1
2,1,854,160,0,5.304347826086956,1014,1014.0,0
2,0,49,211,37,0.23113207547169812,260,6.842105263157895,0
0,3,519,852,19,0.608440797186401,1371,68.55,0
0,1,203,506,36,0.40039447731755423,709,19.16216216216216,0
0,3,444,490,17,0.9042769857433809,934,51.888888888888886,0
1,0,483,1170,19,0.41246797608881297,1653,82.65,0
1,3,644,488,67,1.3169734151329244,1132,16.647058823529413,0
0,1,917,342,7,2.673469387755102,1259,157.375,0
2,2,846,2625,7,0.32216298552932215,3471,433.875,0
2,3,39,6,24,5.571428571428571,45,1.8,0
1,1,1389,291,32,4.756849315068493,1680,50.90909090909091,0
1,1,2979,752,13,3.956175298804781,3731,266.5,0
0,0,428,1221,21,0.3502454991816694,1649,74.95454545454545,0
2,1,198,1356,7,0.14591009579955785,1554,194.25,0
0,2,776,37,4,20.42105263157895,813,162.6,0
1,2,1220,987,8,1.2348178137651822,2207,245.22222222222223,0
2,3,1136,1019,74,1.1137254901960785,2155,28.733333333333334,0
2,3,947,192,48,4.9067357512953365,1139,23.244897959183675,1
1,3,158,95,4,1.6458333333333333,253,50.6,0
0,3,1812,1108,1,1.6339044183949505,2920,1460.0,0
0,2,554,229,2,2.408695652173913,783,261.0,0
2,0,250,1,10,125.0,251,22.818181818181817,0
1,3,90,202,50,0.4433497536945813,292,5.7254901960784315,0
2,0,539,25,11,20.73076923076923,564,47.0,1
1,1,962,229,6,4.182608695652174,1191,170.14285714285714,0
0,1,1094,326,15,3.345565749235474,1420,88.75,0
1,3,3289,253,3,12.948818897637794,3542,885.5,1
0,1,166,2019,19,0.08217821782178218,2185,109.25,0
1,0,4252,211,33,20.056603773584907,4463,131.26470588235293,0
2,0,1063,504,13,2.104950495049505,1567,111.92857142857143,0
0,1,605,2525,5,0.23950910530482977,3130,521.6666666666666,0
2,3,2190,1690,18,1.2950916617386161,3880,204.21052631578948,0
2,0,1185,295,43,4.003378378378378,1480,33.63636363636363,0
0,0,428,316,2,1.3501577287066246,744,248.0,0
0,2,2154,719,2,2.9916666666666667,2873,957.6666666666666,0
2,3,1098,1999,11,0.549,3097,258.0833333333333,0
2,2,1200,8,16,133.33333333333334,1208,71.05882352941177,0
2,1,2267,399,7,5.6675,2666,333.25,1
2,1,594,1516,0,0.39156229400131837,2110,2110.0,1
0,2,1069,422,7,2.5271867612293146,1491,186.375,0
0,3,1365,1018,17,1.33954857703631,2383,132.38888888888889,0
2,0,605,941,2,0.6422505307855626,1546,515.3333333333334,0
1,1,87,183,37,0.47282608695652173,270,7.105263157894737,0
1,3,1475,477,24,3.085774058577406,1952,78.08,1
0,3,48,668,17,0.07174887892376682,716,39.77777777777778,0
2,1,1265,1005,21,1.257455268389662,2270,103.18181818181819,0
2,1,2417,1382,31,1.7476500361532898,3799,118.71875,0
0,3,426,1141,157,0.37302977232924694,1567,9.917721518987342,0
1,0,107,22,44,4.6521739130434785,129,2.8666666666666667,0
1,2,265,888,23,0.2980877390326209,1153,48.041666666666664,0
1,1,826,550,44,1.4990925589836661,1376,30.57777777777778,0
0,2,2858,682,19,4.184480234260615,3540,177.0,1
1,3,718,373,11,1.9197860962566844,1091,90.91666666666667,0
0,2,119,1001,9,0.1187624750499002,1120,112.0,0
0,0,988,896,15,1.1014492753623188,1884,117.75,0
2,3,1319,693,0,1.9005763688760806,2012,2012.0,0
1,0,499,1582,5,0.31522425773847124,2081,346.8333333333333,0
0,3,1278,85,4,14.86046511627907,1363,272.6,0
1,0,392,286,96,1.3658536585365855,678,6.989690721649485,0
1,3,1556,546,2,2.8446069469835464,2102,700.6666666666666,0
2,0,417,2547,20,0.16365777080062793,2964,141.14285714285714,0
1,3,295,59,75,4.916666666666667,354,4.657894736842105,0
2,0,2113,328,28,6.422492401215806,2441,84.17241379310344,0
0,3,795,2081,20,0.3818443804034582,2876,136.95238095238096,0
1,0,335,1825,40,0.18346111719605696,2160,52.68292682926829,0
0,1,2734,1603,13,1.7044887780548628,4337,309.7857142857143,1
1,2,1173,294,6,3.976271186440678,1467,209.57142857142858,1
0,3,249,1500,56,0.1658894070619587,1749,30.68421052631579,0
1,0,953,563,1,1.6897163120567376,1516,758.0,0
1,1,2042,773,49,2.6382428940568476,2815,56.3,0
1,3,1191,218,3,5.438356164383562,1409,352.25,0
1,3,280,981,29,0.285132382892057,1261,42.03333333333333,0
1,3,1046,317,19,3.289308176100629,1363,68.15,0
1,2,965,337,195,2.8550295857988166,1302,6.642857142857143,0
1,0,1719,810,14,2.11960542540074,2529,168.6,0
1,0,196,219,94,0.8909090909090909,415,4.368421052631579,0
1,3,1202,203,15,5.892156862745098,1405,87.8125,0
0,3,27,368,34,0.07317073170731707,395,11.285714285714286,0
2,3,1191,1204,30,0.9883817427385893,2395,77.25806451612904,0
1,1,3229,203,2,15.82843137254902,3432,1144.0,0
2,3,191,1238,40,0.15415657788539144,1429,34.853658536585364,0
1,2,372,951,7,0.3907563025210084,1323,165.375,0
1,0,874,909,14,0.9604395604395605,1783,118.86666666666666,0
0,2,1318,515,45,2.554263565891473,1833,39.84782608695652,0
0,3,422,1095,86,0.38503649635036497,1517,17.436781609195403,0
2,1,1091,10,24,99.18181818181819,1101,44.04,0
0,3,2295,291,21,7.859589041095891,2586,117.54545454545455,1
0,3,1296,909,21,1.4241758241758242,2205,100.22727272727273,0
2,3,1241,3492,50,0.35528199255654164,4733,92.80392156862744,1
0,3,481,2,149,160.33333333333334,483,3.22,0
1,3,2423,570,30,4.243432574430823,2993,96.54838709677419,0
2,0,324,2059,14,0.15728155339805824,2383,158.86666666666667,0
2,2,229,1593,7,0.14366373902132998,1822,227.75,0
1,1,452,18,6,23.789473684210527,470,67.14285714285714,0
0,3,1050,603,58,1.7384105960264902,1653,28.016949152542374,0
2,1,1978,3,146,494.5,1981,13.476190476190476,0
2,0,141,1246,35,0.11307137129109864,1387,38.52777777777778,0
1,2,1680,295,93,5.675675675675675,1975,21.01063829787234,1
1,3,1675,1160,12,1.442721791559001,2835,218.07692307692307,0
0,0,884,2317,29,0.3813632441760138,3201,106.7,0
2,0,1429,2986,21,0.47840642785403414,4415,200.6818181818182,0
0,2,200,1796,19,0.11129660545353366,1996,99.8,0
0,3,185,182,30,1.010928961748634,367,11.838709677419354,0
1,2,1986,173,11,11.413793103448276,2159,179.91666666666666,0
2,2,689,786,30,0.8754764930114358,1475,47.58064516129032,0
2,1,282,628,33,0.4483306836248013,910,26.764705882352942,0
2,1,1167,7,54,145.875,1174,21.345454545454544,1
1,2,2224,397,39,5.5879396984924625,2621,65.525,1
1,1,1000,1897,11,0.5268703898840885,2897,241.41666666666666,0
1,0,426,1829,17,0.23278688524590163,2255,125.27777777777777,0
1,2,660,182,3,3.6065573770491803,842,210.5,1
1,3,1395,384,8,3.6233766233766236,1779,197.66666666666666,0
2,3,69,657,22,0.10486322188449848,726,31.565217391304348,0
0,0,244,1532,3,0.15916503587736464,1776,444.0,0
2,3,620,607,25,1.019736842105263,1227,47.19230769230769,0
0,3,926,2758,14,0.33562885103298296,3684,245.6,0
1,2,414,1283,1,0.32242990654205606,1697,848.5,0
0,0,354,2447,17,0.14460784313725492,2801,155.61111111111111,0
2,2,42,1051,9,0.039923954372623575,1093,109.3,0
2,0,33,1680,2,0.019631171921475312,1713,571.0,0
0,2,326,1422,10,0.22909346451159524,1748,158.9090909090909,0
1,2,756,234,10,3.217021276595745,990,90.0,0
1,1,812,208,13,3.8851674641148324,1020,72.85714285714286,1
2,3,681,1598,13,0.425891181988743,2279,162.78571428571428,0
0,0,527,70,16,7.422535211267606,597,35.11764705882353,0
1,3,290,420,2,0.6888361045130641,710,236.66666666666666,0
1,1,511,1374,0,0.37163636363636365,1885,1885.0,0
2,0,149,1342,39,0.11094564408041697,1491,37.275,0
1,1,122,119,12,1.0166666666666666,241,18.53846153846154,0
0,3,356,535,28,0.664179104477612,891,30.724137931034484,0
2,2,5370,522,11,10.267686424474187,5892,491.0,0
2,1,395,312,124,1.2619808306709266,707,5.656,0
0,1,2756,1992,11,1.3828399397892623,4748,395.6666666666667,1
2,2,498,847,27,0.5872641509433962,1345,48.035714285714285,0
1,3,578,3137,7,0.18419375398342894,3715,464.375,0
1,1,1594,55,21,28.464285714285715,1649,74.95454545454545,1
0,3,98,401,25,0.24378109452736318,499,19.192307692307693,0
1,2,201,1442,6,0.1392931392931393,1643,234.71428571428572,0
0,0,3643,439,3,8.279545454545454,4082,1020.5,0
0,1,705,242,109,2.9012345679012346,947,8.60909090909091,0
1,3,45,4898,67,0.009185548071034905,4943,72.69117647058823,0
0,2,48,1651,32,0.029055690072639227,1699,51.484848484848484,0
1,2,2377,632,59,3.755134281200632,3009,50.15,0
2,1,2066,659,3,3.1303030303030304,2725,681.25,0
2,0,613,5,39,102.16666666666667,618,15.45,0
0,1,178,3170,10,0.056133711762850834,3348,304.3636363636364,0
1,3,1773,1313,23,1.3493150684931507,3086,128.58333333333334,0
1,2,392,29,43,13.066666666666666,421,9.568181818181818,1
2,0,543,155,1,3.480769230769231,698,349.0,1
2,3,1147,1376,35,0.8329702251270878,2523,70.08333333333333,0
1,1,436,72,17,5.972602739726027,508,28.22222222222222,0
0,2,990,2274,17,0.4351648351648352,3264,181.33333333333334,0
2,1,2165,7299,71,0.2965753424657534,9464,131.44444444444446,0
0,0,1596,1740,58,0.9167145318782309,3336,56.54237288135593,0
0,0,480,1074,1,0.44651162790697674,1554,777.0,0
2,0,339,534,28,0.6336448598130842,873,30.103448275862068,0
0,0,336,68,17,4.869565217391305,404,22.444444444444443,0
0,0,428,1048,3,0.40800762631077214,1476,369.0,0
1,1,680,404,57,1.6790123456790123,1084,18.689655172413794,0
0,0,538,675,2,0.7958579881656804,1213,404.3333333333333,0
1,0,142,277,0,0.5107913669064749,419,419.0,0
2,2,178,221,6,0.8018018018018018,399,57.0,0
2,0,419,313,10,1.3343949044585988,732,66.54545454545455,0
1,2,825,1344,1,0.6133828996282528,2169,1084.5,0
2,2,898,444,30,2.0179775280898875,1342,43.29032258064516,0
0,2,665,298,17,2.2240802675585285,963,53.5,0
0,1,1342,453,15,2.9559471365638768,1795,112.1875,0
0,1,1336,26,4,49.48148148148148,1362,272.4,0
2,3,557,1770,17,0.3145115753811406,2327,129.27777777777777,0
0,3,132,641,14,0.205607476635514,773,51.53333333333333,0
2,2,755,88,14,8.48314606741573,843,56.2,0
0,1,480,272,7,1.7582417582417582,752,94.0,0
1,0,148,3286,2,0.04502585944630362,3434,1144.6666666666667,0
2,3,4007,719,9,5.565277777777778,4726,472.6,0
2,1,461,275,33,1.6702898550724639,736,21.647058823529413,0
0,0,982,444,2,2.2067415730337077,1426,475.3333333333333,0
2,0,673,239,14,2.8041666666666667,912,60.8,0
2,1,154,25,21,5.923076923076923,179,8.136363636363637,0
1,3,57,1476,99,0.03859174001354096,1533,15.33,0
1,1,982,276,55,3.545126353790614,1258,22.464285714285715,1
0,3,283,1458,74,0.19396847155586017,1741,23.213333333333335,0
1,2,279,520,51,0.5355086372360844,799,15.365384615384615,0
0,1,3146,161,26,19.419753086419753,3307,122.48148148148148,1
0,1,619,1295,59,0.47762345679012347,1914,31.9,0
0,3,29,378,24,0.07651715039577836,407,16.28,0
2,3,415,984,13,0.4213197969543147,1399,99.92857142857143,0
1,1,878,1452,13,0.604267033723331,2330,166.42857142857142,0
0,0,398,2637,25,0.1508718726307809,3035,116.73076923076923,0
1,0,27,71,49,0.375,98,1.96,0
0,0,587,6,4,83.85714285714286,593,118.6,0
1,2,111,636,1,0.17425431711145997,747,373.5,0
1,2,965,245,46,3.9227642276422765,1210,25.74468085106383,0
0,3,966,506,31,1.9053254437869822,1472,46.0,0
2,2,38,60,51,0.6229508196721312,98,1.8846153846153846,0
1,0,343,557,112,0.6146953405017921,900,7.964601769911504,0
2,1,533,106,8,4.981308411214953,639,71.0,1
2,2,799,1459,6,0.5472602739726027,2258,322.57142857142856,0
0,2,351,1139,12,0.3078947368421053,1490,114.61538461538461,0
0,0,339,61,63,5.467741935483871,400,6.25,0
0,2,4075,1448,0,2.8122843340234644,5523,5523.0,0
1,3,42,314,0,0.13333333333333333,356,356.0,0
0,1,4513,348,7,12.931232091690545,4861,607.625,1
0,0,48,158,14,0.3018867924528302,206,13.733333333333333,0
1,3,340,1442,10,0.23562023562023562,1782,162.0,0
1,0,680,414,52,1.6385542168674698,1094,20.641509433962263,0
0,3,154,40,35,3.7560975609756095,194,5.388888888888889,1
0,1,144,2711,54,0.05309734513274336,2855,51.90909090909091,0
0,1,296,236,14,1.248945147679325,532,35.46666666666667,0
0,3,3630,2201,27,1.6485013623978202,5831,208.25,1
2,3,478,286,21,1.6655052264808363,764,34.72727272727273,0
2,3,834,1424,19,0.5852631578947368,2258,112.9,0
0,3,1218,873,10,1.3935926773455378,2091,190.0909090909091,0
2,3,1355,1580,37,0.8570524984187223,2935,77.23684210526316,0
1,3,1164,2987,22,0.3895582329317269,4151,180.47826086956522,0
2,1,410,1641,2,0.2496954933008526,2051,683.6666666666666,0
2,3,118,413,0,0.28502415458937197,531,531.0,0
0,2,330,1347,0,0.24480712166172106,1677,1677.0,0
2,1,236,994,2,0.2371859296482412,1230,410.0,0
2,0,146,50,13,2.8627450980392157,196,14.0,0
2,1,24,2124,10,0.011294117647058824,2148,195.27272727272728,0
2,0,2744,501,5,5.46613545816733,3245,540.8333333333334,0
1,0,2538,115,21,21.879310344827587,2653,120.5909090909091,0
0,2,51,443,105,0.11486486486486487,494,4.660377358490566,0
0,3,190,739,5,0.25675675675675674,929,154.83333333333334,0
1,3,150,680,8,0.22026431718061673,830,92.22222222222223,0
2,1,330,684,18,0.48175182481751827,1014,53.36842105263158,0
1,3,228,236,30,0.9620253164556962,464,14.96774193548387,0
2,2,2916,801,27,3.6359102244389025,3717,132.75,0
1,1,87,1903,22,0.04569327731092437,1990,86.52173913043478,0
0,1,237,393,40,0.6015228426395939,630,15.365853658536585,0
0,1,84,796,56,0.1053952321204517,880,15.43859649122807,0
0,3,3931,223,206,17.549107142857142,4154,20.067632850241544,0
2,3,2506,39,18,62.65,2545,133.94736842105263,0
2,3,1261,704,158,1.7886524822695036,1965,12.358490566037736,0
1,1,555,38,39,14.23076923076923,593,14.825,0
1,1,210,1028,32,0.20408163265306123,1238,37.515151515151516,0
0,0,250,887,30,0.28153153153153154,1137,36.67741935483871,0
2,0,585,368,72,1.5853658536585367,953,13.054794520547945,0
1,3,1461,423,88,3.4457547169811322,1884,21.168539325842698,0
2,1,307,1998,5,0.1535767883941971,2305,384.1666666666667,0
2,3,372,10,20,33.81818181818182,382,18.19047619047619,1
0,3,916,662,85,1.3815987933634992,1578,18.348837209302324,0
0,0,271,2054,14,0.1318734793187348,2325,155.0,0
2,2,877,1962,7,0.4467651553744269,2839,354.875,0
2,3,489,702,3,0.6955903271692745,1191,297.75,0
2,2,34,384,27,0.08831168831168831,418,14.928571428571429,0
2,2,515,83,36,6.130952380952381,598,16.16216216216216,0
0,1,2519,152,6,16.464052287581698,2671,381.57142857142856,1
1,1,346,910,33,0.37980241492864986,1256,36.94117647058823,0
0,3,389,13,68,27.785714285714285,402,5.826086956521739,0
1,0,68,1719,8,0.03953488372093023,1787,198.55555555555554,0
2,0,954,709,3,1.343661971830986,1663,415.75,0
1,3,1892,36,54,51.13513513513514,1928,35.054545454545455,0
0,3,435,219,74,1.9772727272727273,654,8.72,0
0,0,274,721,7,0.37950138504155123,995,124.375,0
2,2,3137,29,38,104.56666666666666,3166,81.17948717948718,0
0,3,1366,1211,26,1.127062706270627,2577,95.44444444444444,0
2,2,837,2019,8,0.41435643564356434,2856,317.3333333333333,0
0,3,364,2599,52,0.14,2963,55.905660377358494,0
0,3,249,1058,19,0.23512747875354106,1307,65.35,0
2,2,1257,1554,36,0.8083601286173634,2811,75.97297297297297,0
1,2,737,754,10,0.976158940397351,1491,135.54545454545453,0
0,0,735,490,50,1.4969450101832993,1225,24.019607843137255,0
1,3,76,998,9,0.07607607607607608,1074,107.4,0
0,1,717,203,13,3.514705882352941,920,65.71428571428571,0
0,1,1730,93,14,18.404255319148938,1823,121.53333333333333,0
0,3,2933,1147,6,2.5548780487804876,4080,582.8571428571429,0
0,3,112,2539,62,0.04409448818897638,2651,42.07936507936508,0
1,3,997,689,3,1.444927536231884,1686,421.5,0
1,2,840,527,24,1.5909090909090908,1367,54.68,0
0,1,2210,611,50,3.611111111111111,2821,55.31372549019608,0
0,1,1391,520,26,2.669865642994242,1911,70.77777777777777,0
1,1,3359,467,11,7.177350427350428,3826,318.8333333333333,1
2,3,3219,2350,45,1.3692045937898767,5569,121.06521739130434,1
2,2,255,522,20,0.4875717017208413,777,37.0,0
1,3,1292,67,5,19.0,1359,226.5,0
0,0,756,1160,11,0.6511627906976745,1916,159.66666666666666,0
0,0,241,397,26,0.6055276381909548,638,23.62962962962963,0
2,1,216,992,32,0.2175226586102719,1208,36.60606060606061,0
2,3,84,693,23,0.12103746397694524,777,32.375,0
1,0,1587,999,9,1.587,2586,258.6,0
2,0,392,51,27,7.538461538461538,443,15.821428571428571,0
1,3,1944,27,12,69.42857142857143,1971,151.6153846153846,1
2,2,937,380,7,2.459317585301837,1317,164.625,0
2,3,1119,945,87,1.182875264270613,2064,23.454545454545453,0
2,3,344,202,11,1.6945812807881773,546,45.5,0
0,2,611,454,12,1.3428571428571427,1065,81.92307692307692,0
0,1,531,3162,68,0.16787859626936452,3693,53.52173913043478,0
0,1,268,193,4,1.3814432989690721,461,92.2,0
2,1,1786,1506,26,1.1851360318513604,3292,121.92592592592592,0
1,2,973,1396,45,0.6964924838940587,2369,51.5,0
1,0,38,1775,9,0.021396396396396396,1813,181.3,0
1,2,1714,1973,55,0.8682877406281662,3687,65.83928571428571,0
1,3,112,566,44,0.19753086419753085,678,15.066666666666666,0
0,2,517,916,19,0.5637949836423118,1433,71.65,0
0,0,846,771,3,1.0958549222797926,1617,404.25,0
2,0,7,295,105,0.02364864864864865,302,2.849056603773585,0
2,3,1058,262,29,4.022813688212928,1320,44.0,0
1,1,1077,334,21,3.2149253731343284,1411,64.13636363636364,0
0,0,1057,197,65,5.338383838383838,1254,19.0,0
1,0,178,1133,16,0.15696649029982362,1311,77.11764705882354,0
2,0,295,2672,24,0.11036288814066592,2967,118.68,0
2,3,284,1618,58,0.17541692402717726,1902,32.23728813559322,0
1,0,3220,196,14,16.34517766497462,3416,227.73333333333332,1
2,1,69,42,44,1.6046511627906976,111,2.466666666666667,0
1,3,559,1132,8,0.49338040600176525,1691,187.88888888888889,0
0,1,2049,395,36,5.174242424242424,2444,66.05405405405405,0
1,0,1467,1392,21,1.0531227566403445,2859,129.95454545454547,0
0,0,1728,1208,5,1.4292803970223324,2936,489.3333333333333,0
0,1,3586,785,4,4.56234096692112,4371,874.2,1
2,3,489,235,18,2.0720338983050848,724,38.10526315789474,0
2,3,370,87,37,4.204545454545454,457,12.026315789473685,0
2,1,31,232,27,0.13304721030042918,263,9.392857142857142,0
1,0,162,570,57,0.28371278458844135,732,12.620689655172415,0
1,2,825,3108,14,0.2653586362174333,3933,262.2,0
2,1,171,52,55,3.2264150943396226,223,3.982142857142857,1
1,1,1332,178,1,7.441340782122905,1510,755.0,0
2,1,37,789,13,0.04683544303797468,826,59.0,0
1,0,300,290,2,1.0309278350515463,590,196.66666666666666,0
0,3,1188,1564,75,0.7591054313099042,2752,36.21052631578947,0
0,0,295,120,19,2.43801652892562,415,20.75,0
2,1,1304,2640,11,0.4937523665278304,3944,328.6666666666667,0
1,0,5487,1947,20,2.816735112936345,7434,354.0,0
1,0,1594,1748,22,0.9113779302458548,3342,145.30434782608697,0
0,1,418,152,56,2.7320261437908497,570,10.0,0
0,0,2308,319,23,7.2125,2627,109.45833333333333,0
2,2,52,1304,16,0.03984674329501916,1356,79.76470588235294,0
0,0,1291,1319,97,0.978030303030303,2610,26.632653061224488,0
2,0,23,977,103,0.023517382413087935,1000,9.615384615384615,0
0,3,191,475,1,0.4012605042016807,666,333.0,0
0,3,4388,298,36,14.675585284280936,4686,126.64864864864865,1
1,1,447,2636,13,0.1695108077360637,3083,220.21428571428572,0
0,1,1717,119,33,14.308333333333334,1836,54.0,0
0,3,471,35,30,13.083333333333334,506,16.322580645161292,1
2,2,1832,7,12,229.0,1839,141.46153846153845,1
0,0,3365,1193,129,2.818257956448911,4558,35.06153846153846,1
2,2,571,46,13,12.148936170212766,617,44.07142857142857,1
0,2,819,618,29,1.3231017770597737,1437,47.9,0
0,3,990,366,50,2.697547683923706,1356,26.58823529411765,0
2,1,2730,127,4,21.328125,2857,571.4,0
1,0,296,1079,10,0.2740740740740741,1375,125.0,0
2,1,944,45,6,20.52173913043478,989,141.28571428571428,0
2,2,392,306,45,1.276872964169381,698,15.173913043478262,0
2,2,244,660,48,0.3691376701966717,904,18.448979591836736,0
1,1,88,411,8,0.21359223300970873,499,55.44444444444444,0
0,1,969,239,0,4.0375,1208,1208.0,1
2,3,2137,2082,16,1.0259241478636583,4219,248.1764705882353,0
2,1,432,2138,34,0.20196353436185133,2570,73.42857142857143,0
1,1,804,430,29,1.865429234338747,1234,41.13333333333333,0
2,3,1027,400,17,2.561097256857855,1427,79.27777777777777,0
0,1,535,293,10,1.8197278911564625,828,75.27272727272727,0
1,2,2336,1549,19,1.5070967741935484,3885,194.25,0
0,1,450,671,0,0.6696428571428571,1121,1121.0,0
0,0,133,75,2,1.75,208,69.33333333333333,0
1,2,155,1535,5,0.10091145833333333,1690,281.6666666666667,0
2,3,2215,612,29,3.6133768352365414,2827,94.23333333333333,0
0,2,4423,429,7,10.286046511627907,4852,606.5,1
0,3,340,329,16,1.0303030303030303,669,39.35294117647059,0
0,0,155,83,29,1.8452380952380953,238,7.933333333333334,0
0,0,658,2511,53,0.2619426751592357,3169,58.68518518518518,0
1,2,1236,1081,23,1.1423290203327172,2317,96.54166666666667,0
1,1,947,113,5,8.307017543859649,1060,176.66666666666666,0
0,2,3018,572,90,5.267015706806283,3590,39.45054945054945,0
2,2,1702,648,2,2.6224961479198767,2350,783.3333333333334,0
0,0,2032,147,13,13.72972972972973,2179,155.64285714285714,0
2,3,780,445,76,1.748878923766816,1225,15.909090909090908,0
0,2,396,830,27,0.47653429602888087,1226,43.785714285714285,0
2,1,1209,267,32,4.5111940298507465,1476,44.72727272727273,0
0,0,578,322,10,1.7894736842105263,900,81.81818181818181,0
2,2,339,104,2,3.2285714285714286,443,147.66666666666666,1
0,2,165,426,13,0.3864168618266979,591,42.214285714285715,0
0,1,750,701,15,1.0683760683760684,1451,90.6875,0
2,2,902,99,9,9.02,1001,100.1,0
1,2,841,763,7,1.100785340314136,1604,200.5,0
2,2,123,405,13,0.30295566502463056,528,37.714285714285715,0
1,2,843,907,30,0.9284140969162996,1750,56.45161290322581,0
0,1,184,302,89,0.6072607260726073,486,5.4,0
2,2,1089,672,36,1.6181277860326895,1761,47.5945945945946,0
2,2,561,759,45,0.7381578947368421,1320,28.695652173913043,0
2,2,1889,938,10,2.0117145899893503,2827,257.0,0
1,0,1506,1131,3,1.3303886925795052,2637,659.25,0
1,1,1288,117,10,10.915254237288135,1405,127.72727272727273,1
0,0,1206,2687,15,0.4486607142857143,3893,243.3125,0
1,0,822,1484,35,0.5535353535353535,2306,64.05555555555556,0
1,1,63,661,84,0.09516616314199396,724,8.51764705882353,0
0,0,1065,1768,49,0.6020350480497456,2833,56.66,0
2,0,629,385,9,1.6295336787564767,1014,101.4,0
2,0,634,27,51,22.642857142857142,661,12.711538461538462,0
0,1,476,1038,15,0.45813282001924927,1514,94.625,0
2,2,2646,2296,5,1.151937309534175,4942,823.6666666666666,1
1,3,286,141,18,2.0140845070422535,427,22.473684210526315,0
0,3,380,825,24,0.4600484261501211,1205,48.2,0
0,1,3297,1343,43,2.453125,4640,105.45454545454545,0
0,3,1661,1883,12,0.8816348195329087,3544,272.61538461538464,0
2,1,14,258,4,0.05405405405405406,272,54.4,0
0,1,2365,110,2,21.306306306306308,2475,825.0,0
0,3,257,227,3,1.1271929824561404,484,121.0,0
0,0,1223,689,89,1.772463768115942,1912,21.244444444444444,0
2,2,805,2007,90,0.40089641434262946,2812,30.9010989010989,0
1,3,769,698,103,1.100143061516452,1467,14.10576923076923,0
0,3,1265,2016,10,0.6271690629647992,3281,298.27272727272725,0
1,3,232,1175,6,0.19727891156462585,1407,201.0,0
2,3,173,729,118,0.236986301369863,902,7.579831932773109,0
2,1,1055,17,133,58.611111111111114,1072,8.0,1
2,1,343,324,2,1.0553846153846154,667,222.33333333333334,0
2,2,3647,47,41,75.97916666666667,3694,87.95238095238095,0
1,2,600,311,10,1.9230769230769231,911,82.81818181818181,0
0,3,118,51,72,2.269230769230769,169,2.315068493150685,0
2,3,1157,146,2,7.870748299319728,1303,434.3333333333333,1
2,3,365,423,65,0.8608490566037735,788,11.93939393939394,0
1,2,160,578,0,0.2763385146804836,738,738.0,0
1,3,549,195,22,2.8010204081632653,744,32.34782608695652,0
2,0,3330,1055,12,3.153409090909091,4385,337.3076923076923,1
0,2,530,713,16,0.742296918767507,1243,73.11764705882354,0
0,0,426,941,17,0.45222929936305734,1367,75.94444444444444,0
2,3,587,1055,31,0.5558712121212122,1642,51.3125,0
1,1,12,1038,0,0.011549566891241578,1050,1050.0,0
2,0,142,2202,35,0.06445755787562416,2344,65.11111111111111,0
2,2,1894,216,0,8.728110599078342,2110,2110.0,0
1,0,3818,251,6,15.15079365079365,4069,581.2857142857143,1
2,2,171,79,27,2.1375,250,8.928571428571429,0
2,3,766,718,2,1.0653685674547984,1484,494.6666666666667,0
2,0,3391,402,140,8.41439205955335,3793,26.900709219858157,1
1,1,170,548,46,0.30965391621129323,718,15.27659574468085,0
0,0,206,148,36,1.3825503355704698,354,9.567567567567568,0
0,1,2614,837,9,3.119331742243437,3451,345.1,0
1,2,1223,772,1,1.5821474773609314,1995,997.5,0
0,3,164,246,115,0.6639676113360324,410,3.5344827586206895,0
2,3,500,501,4,0.9960159362549801,1001,200.2,0
0,1,57,1797,53,0.03170189098998888,1854,34.333333333333336,0
2,2,566,1188,6,0.4760302775441548,1754,250.57142857142858,0
0,3,1504,205,14,7.300970873786408,1709,113.93333333333334,0
1,2,807,1688,35,0.477797513321492,2495,69.30555555555556,0
0,1,1042,55,87,18.607142857142858,1097,12.465909090909092,0
0,1,395,427,0,0.9228971962616822,822,822.0,0
0,0,176,66,9,2.626865671641791,242,24.2,0
1,3,13,2063,43,0.006298449612403101,2076,47.18181818181818,0
0,3,1722,33,5,50.64705882352941,1755,292.5,0
1,0,1012,131,3,7.666666666666667,1143,285.75,1
2,1,260,1972,1,0.13177901672579828,2232,1116.0,0
0,1,542,698,20,0.7753934191702432,1240,59.04761904761905,0
1,1,1616,1268,43,1.2734436564223799,2884,65.54545454545455,0
1,1,773,13,97,55.214285714285715,786,8.020408163265307,1
0,2,356,434,9,0.8183908045977012,790,79.0,0
2,3,310,3331,3,0.09303721488595439,3641,910.25,0
1,3,245,693,15,0.3530259365994236,938,58.625,0
0,1,1735,1516,1,1.1437046802900461,3251,1625.5,0
2,1,871,2649,12,0.3286792452830189,3520,270.7692307692308,0
1,1,1234,924,30,1.334054054054054,2158,69.61290322580645,0
1,3,1966,317,5,6.182389937106918,2283,380.5,1
2,3,4332,295,29,14.635135135135135,4627,154.23333333333332,0
2,1,286,59,107,4.766666666666667,345,3.1944444444444446,0
0,2,199,446,59,0.4451901565995526,645,10.75,0
0,0,619,1975,13,0.3132591093117409,2594,185.28571428571428,0
1,0,35,520,16,0.0671785028790787,555,32.64705882352941,0
2,0,1568,1935,16,0.8099173553719008,3503,206.05882352941177,0
2,3,2152,1359,58,1.5823529411764705,3511,59.50847457627118,0
2,3,1158,3317,152,0.34900542495479203,4475,29.248366013071895,1
1,0,311,2360,52,0.13172384582803898,2671,50.39622641509434,0
2,0,131,980,24,0.13353720693170235,1111,44.44,0
2,2,481,1639,3,0.29329268292682925,2120,530.0,0
1,3,1791,1102,92,1.6237533998186764,2893,31.107526881720432,0
0,3,427,972,58,0.43884892086330934,1399,23.71186440677966,0
0,0,34,1005,55,0.033797216699801194,1039,18.553571428571427,0
1,2,320,1021,14,0.3131115459882583,1341,89.4,0
2,2,4599,381,17,12.039267015706807,4980,276.6666666666667,1
1,0,1129,440,3,2.560090702947846,1569,392.25,0
0,0,2311,278,83,8.283154121863799,2589,30.821428571428573,0
0,3,1491,128,86,11.55813953488372,1619,18.60919540229885,0
1,0,775,490,8,1.5784114052953158,1265,140.55555555555554,0
1,1,160,1841,35,0.08686210640608034,2001,55.583333333333336,0
0,2,428,842,6,0.5077105575326216,1270,181.42857142857142,0
1,0,876,46,14,18.638297872340427,922,61.46666666666667,0
0,1,2045,1333,10,1.5329835082458771,3378,307.09090909090907,0
1,2,312,2191,14,0.14233576642335766,2503,166.86666666666667,0
1,1,129,1414,11,0.0911660777385159,1543,128.58333333333334,0
1,1,818,1040,12,0.7857829010566763,1858,142.92307692307693,0
0,0,194,130,46,1.4809160305343512,324,6.8936170212765955,0
1,2,942,343,10,2.738372093023256,1285,116.81818181818181,0
0,1,305,666,50,0.4572713643178411,971,19.03921568627451,0
0,3,262,63,25,4.09375,325,12.5,0
1,2,509,89,45,5.655555555555556,598,13.0,0
1,3,899,2177,75,0.41276400367309457,3076,40.473684210526315,0
0,0,788,970,4,0.811534500514933,1758,351.6,0
0,3,280,257,12,1.0852713178294573,537,41.30769230769231,0
2,2,2217,317,1,6.971698113207547,2534,1267.0,0
0,1,116,388,15,0.2982005141388175,504,31.5,0
2,1,40,62,8,0.6349206349206349,102,11.333333333333334,0
2,2,923,1075,25,0.8578066914498141,1998,76.84615384615384,0
2,1,131,155,45,0.8397435897435898,286,6.217391304347826,0
1,3,702,1308,19,0.5362872421695951,2010,100.5,0
1,1,3031,1495,12,2.0260695187165774,4526,348.15384615384613,0
0,1,1199,813,4,1.472972972972973,2012,402.4,0
2,3,960,1175,0,0.8163265306122449,2135,2135.0,1
1,3,855,150,33,5.662251655629139,1005,29.558823529411764,1
1,3,197,686,0,0.2867540029112082,883,883.0,0
1,0,566,903,76,0.6261061946902655,1469,19.07792207792208,0
1,3,419,866,27,0.48327566320645904,1285,45.892857142857146,0
1,3,3059,99,13,30.59,3158,225.57142857142858,1
2,0,277,337,1,0.8195266272189349,614,307.0,0
2,1,637,314,16,2.022222222222222,951,55.94117647058823,0
2,3,2781,679,60,4.089705882352941,3460,56.721311475409834,0
2,2,1556,1159,105,1.3413793103448275,2715,25.61320754716981,0
0,3,3338,676,2,4.930576070901034,4014,1338.0,1
2,3,937,1124,45,0.8328888888888889,2061,44.80434782608695,0
1,0,406,83,8,4.833333333333333,489,54.333333333333336,0
2,2,1752,1683,14,1.0403800475059382,3435,229.0,0
0,1,344,615,23,0.5584415584415584,959,39.958333333333336,0
1,1,180,30,157,5.806451612903226,210,1.3291139240506329,0
2,2,1225,824,7,1.4848484848484849,2049,256.125,0
2,3,1018,582,4,1.7461406518010292,1600,320.0,0
2,0,2111,199,27,10.555,2310,82.5,0
1,2,3268,1156,57,2.8245462402765775,4424,76.27586206896552,1
1,2,1946,2169,31,0.896774193548387,4115,128.59375,0
0,1,61,311,12,0.1955128205128205,372,28.615384615384617,0
1,0,1092,544,113,2.003669724770642,1636,14.350877192982455,0
1,2,1535,109,159,13.954545454545455,1644,10.275,0
2,0,4013,2125,44,1.88758231420508,6138,136.4,0
1,3,469,307,48,1.5227272727272727,776,15.83673469387755,0
2,1,186,173,42,1.0689655172413792,359,8.348837209302326,0
2,3,1916,520,8,3.677543186180422,2436,270.6666666666667,1
1,0,381,35,4,10.583333333333334,416,83.2,0
0,3,911,233,24,3.893162393162393,1144,45.76,0
0,1,494,56,92,8.666666666666666,550,5.913978494623656,1
1,0,514,108,63,4.715596330275229,622,9.71875,0
0,2,1318,95,3,13.729166666666666,1413,353.25,0
2,3,448,1647,1,0.27184466019417475,2095,1047.5,0
2,1,1181,2132,62,0.553680262541022,3313,52.58730158730159,0
1,2,14,514,28,0.027184466019417475,528,18.20689655172414,0
0,1,392,796,10,0.4918444165621079,1188,108.0,0
0,0,384,952,24,0.40293809024134314,1336,53.44,0
2,0,1381,397,7,3.469849246231156,1778,222.25,0
1,3,377,369,88,1.018918918918919,746,8.382022471910112,0
0,1,1003,900,52,1.1132075471698113,1903,35.905660377358494,0
1,1,1166,378,98,3.0765171503957784,1544,15.595959595959595,0
0,1,1074,695,6,1.543103448275862,1769,252.71428571428572,0
2,0,924,579,55,1.5931034482758621,1503,26.839285714285715,0
2,3,533,594,24,0.8957983193277311,1127,45.08,0
1,1,467,1414,11,0.3300353356890459,1881,156.75,0
2,1,831,974,19,0.8523076923076923,1805,90.25,0
0,2,65,2588,86,0.025106218617226728,2653,30.49425287356322,0
2,1,2086,1252,35,1.664804469273743,3338,92.72222222222223,0
1,3,1744,126,13,13.73228346456693,1870,133.57142857142858,1
1,2,425,1073,276,0.3957169459962756,1498,5.407942238267148,0
1,2,836,876,12,0.9532497149372862,1712,131.69230769230768,0
0,2,2691,830,50,3.2382671480144403,3521,69.03921568627452,0
0,0,316,524,46,0.6019047619047619,840,17.872340425531913,0
0,2,1356,51,38,26.076923076923077,1407,36.07692307692308,0
0,1,86,2420,33,0.035522511358942584,2506,73.70588235294117,0
0,0,741,1528,3,0.48463047743623283,2269,567.25,0
2,0,2153,533,158,4.031835205992509,2686,16.89308176100629,0
0,0,802,138,5,5.76978417266187,940,156.66666666666666,1
0,0,957,1391,27,0.6875,2348,83.85714285714286,0
2,0,2382,450,8,5.281596452328159,2832,314.6666666666667,0
0,0,1256,395,5,3.1717171717171717,1651,275.1666666666667,0
1,0,1190,875,24,1.3584474885844748,2065,82.6,0
0,2,882,1137,54,0.7750439367311072,2019,36.70909090909091,0
0,3,1002,51,14,19.26923076923077,1053,70.2,0
1,1,1628,1167,2,1.393835616438356,2795,931.6666666666666,0
1,1,3874,1059,29,3.6547169811320757,4933,164.43333333333334,1
1,2,1586,711,43,2.2275280898876404,2297,52.20454545454545,0
1,2,1229,330,10,3.712990936555891,1559,141.72727272727272,0
0,0,145,144,35,1.0,289,8.027777777777779,0
1,3,1698,86,2,19.517241379310345,1784,594.6666666666666,1
1,0,1331,0,13,1331.0,1331,95.07142857142857,1
2,2,1471,185,19,7.908602150537634,1656,82.8,1
1,0,262,423,45,0.6179245283018868,685,14.891304347826088,0
1,1,2337,223,12,10.433035714285714,2560,196.92307692307693,0
2,1,102,295,18,0.34459459459459457,397,20.894736842105264,0
2,0,292,396,29,0.7355163727959698,688,22.933333333333334,0
0,3,1087,294,29,3.6847457627118643,1381,46.03333333333333,1
2,0,1119,1031,21,1.0843023255813953,2150,97.72727272727273,0
0,0,375,541,11,0.6918819188191881,916,76.33333333333333,0
2,3,1209,15,33,75.5625,1224,36.0,1
2,3,490,205,54,2.378640776699029,695,12.636363636363637,0
0,3,0,989,5,0.0,989,164.83333333333334,0
2,1,177,286,12,0.6167247386759582,463,35.61538461538461,0
0,0,2142,2022,33,1.0588235294117647,4164,122.47058823529412,0
2,2,251,997,42,0.251503006012024,1248,29.023255813953487,0
1,3,119,273,45,0.4343065693430657,392,8.521739130434783,0
2,3,1146,581,31,1.9690721649484537,1727,53.96875,0
0,0,581,880,19,0.659477866061294,1461,73.05,0
2,2,1592,171,31,9.255813953488373,1763,55.09375,0
0,0,1976,226,4,8.704845814977974,2202,440.4,0
0,0,1870,565,6,3.303886925795053,2435,347.85714285714283,0
1,3,375,2071,78,0.18098455598455598,2446,30.962025316455698,0
1,3,704,337,76,2.0828402366863905,1041,13.519480519480519,0
0,1,1050,411,38,2.5485436893203883,1461,37.46153846153846,0
2,2,388,169,11,2.2823529411764705,557,46.416666666666664,0
0,2,41,719,31,0.05694444444444444,760,23.75,0
0,3,684,1078,34,0.633920296570899,1762,50.34285714285714,0
2,3,12,464,21,0.025806451612903226,476,21.636363636363637,0
2,3,3008,1109,41,2.7099099099099098,4117,98.02380952380952,0
2,2,1592,288,0,5.508650519031142,1880,1880.0,0
2,1,213,982,8,0.21668362156663276,1195,132.77777777777777,0
0,2,339,239,47,1.4125,578,12.041666666666666,0
0,3,4065,1213,83,3.3484349258649093,5278,62.833333333333336,1
1,3,467,1420,62,0.3286418015482055,1887,29.952380952380953,0
0,1,1531,1278,37,1.1970289288506646,2809,73.92105263157895,0
2,0,592,194,5,3.0358974358974358,786,131.0,0
1,0,1995,947,13,2.1044303797468356,2942,210.14285714285714,0
2,2,1216,618,1,1.9644588045234248,1834,917.0,0
0,0,23,3417,30,0.006729081334113517,3440,110.96774193548387,0
1,0,348,359,17,0.9666666666666667,707,39.27777777777778,0
2,2,816,1180,25,0.6909398814563928,1996,76.76923076923077,0
1,3,2606,369,116,7.043243243243243,2975,25.427350427350426,0
1,0,107,404,15,0.2641975308641975,511,31.9375,0
0,3,919,94,10,9.673684210526316,1013,92.0909090909091,0
2,2,359,219,4,1.6318181818181818,578,115.6,0
1,3,2201,143,4,15.284722222222221,2344,468.8,0
1,3,1448,138,21,10.417266187050359,1586,72.0909090909091,1
2,2,461,7,41,57.625,468,11.142857142857142,0
1,3,182,1263,24,0.1439873417721519,1445,57.8,0
1,0,11,504,61,0.02178217821782178,515,8.306451612903226,0
1,0,970,1304,11,0.7432950191570882,2274,189.5,0
2,0,521,758,27,0.686429512516469,1279,45.67857142857143,0
2,0,377,1423,32,0.26474719101123595,1800,54.54545454545455,0
2,3,4233,560,9,7.545454545454546,4793,479.3,1
2,0,627,79,15,7.8375,706,44.125,0
0,3,1385,767,26,1.8033854166666667,2152,79.70370370370371,0
1,1,195,905,0,0.2152317880794702,1100,1100.0,0
2,3,13,787,65,0.01649746192893401,800,12.121212121212121,0
1,0,540,1292,3,0.4176334106728538,1832,458.0,0
1,1,1095,1051,1,1.040874524714829,2146,1073.0,0
0,2,706,453,7,1.5550660792951543,1159,144.875,0
2,3,2211,1367,20,1.6162280701754386,3578,170.38095238095238,0
2,0,569,941,11,0.6040339702760085,1510,125.83333333333333,0
1,0,372,102,17,3.6116504854368934,474,26.333333333333332,0
2,0,2477,621,2,3.982315112540193,3098,1032.6666666666667,0
1,2,522,1043,7,0.5,1565,195.625,0
1,1,314,644,3,0.4868217054263566,958,239.5,0
0,1,102,2381,7,0.042821158690176324,2483,310.375,0
0,0,1576,85,36,18.325581395348838,1661,44.891891891891895,1
0,3,1743,1025,25,1.6988304093567252,2768,106.46153846153847,0
1,0,33,1391,12,0.023706896551724137,1424,109.53846153846153,0
2,0,444,970,9,0.4572605561277034,1414,141.4,0
0,3,1385,389,180,3.551282051282051,1774,9.80110497237569,1
2,0,2925,389,43,7.5,3314,75.31818181818181,0
0,2,474,706,51,0.6704384724186704,1180,22.692307692307693,0
0,0,2056,404,0,5.076543209876543,2460,2460.0,0
1,2,500,1717,1,0.2910360884749709,2217,1108.5,0
0,0,197,93,37,2.095744680851064,290,7.631578947368421,0
0,1,3,815,6,0.003676470588235294,818,116.85714285714286,0
1,3,400,115,16,3.4482758620689653,515,30.294117647058822,0
2,1,475,621,6,0.7636655948553055,1096,156.57142857142858,0
0,0,2902,1005,5,2.8846918489065607,3907,651.1666666666666,0
1,0,230,144,3,1.5862068965517242,374,93.5,0
0,2,481,974,27,0.49333333333333335,1455,51.964285714285715,0
1,0,25,120,40,0.2066115702479339,145,3.5365853658536586,0
2,0,1441,775,1,1.856958762886598,2216,1108.0,0
2,0,2466,563,9,4.372340425531915,3029,302.9,0
1,1,271,283,32,0.954225352112676,554,16.78787878787879,0
1,2,560,94,14,5.894736842105263,654,43.6,0
1,1,130,1065,36,0.12195121951219512,1195,32.2972972972973,0
2,2,610,384,42,1.5844155844155845,994,23.11627906976744,0
0,1,143,72,0,1.9589041095890412,215,215.0,0
2,0,740,1185,14,0.6239460370994941,1925,128.33333333333334,0
1,1,1326,212,39,6.225352112676056,1538,38.45,1
1,1,805,1066,14,0.7544517338331771,1871,124.73333333333333,0
2,2,281,665,0,0.4219219219219219,946,946.0,0
1,2,436,173,12,2.5057471264367814,609,46.84615384615385,0
2,1,1017,63,61,15.890625,1080,17.419354838709676,1
1,2,891,719,91,1.2375,1610,17.5,0
0,2,147,20,24,7.0,167,6.68,0
0,2,1864,54,10,33.89090909090909,1918,174.36363636363637,1
1,3,644,969,18,0.6639175257731958,1613,84.89473684210526,0
2,2,177,619,8,0.2854838709677419,796,88.44444444444444,0
0,3,131,315,5,0.41455696202531644,446,74.33333333333333,0
2,3,3368,619,20,5.432258064516129,3987,189.85714285714286,0
1,2,330,716,40,0.4602510460251046,1046,25.51219512195122,0
2,1,2392,666,7,3.586206896551724,3058,382.25,0
0,2,528,823,72,0.6407766990291263,1351,18.506849315068493,0
2,0,487,2254,5,0.21596452328159646,2741,456.8333333333333,0
2,1,1207,393,24,3.063451776649746,1600,64.0,0
1,3,9,286,44,0.0313588850174216,295,6.555555555555555,0
1,3,412,31,7,12.875,443,55.375,0
1,1,360,127,10,2.8125,487,44.27272727272727,0
0,1,2025,89,1,22.5,2114,1057.0,0
0,2,753,326,86,2.302752293577982,1079,12.402298850574713,0
1,3,453,753,20,0.6007957559681698,1206,57.42857142857143,0
1,0,309,37,1,8.131578947368421,346,173.0,1
0,2,892,1040,53,0.8568683957732949,1932,35.77777777777778,0
0,1,164,405,25,0.4039408866995074,569,21.884615384615383,0
0,3,282,2648,1,0.10645526613816535,2930,1465.0,0
0,1,347,672,17,0.5156017830609212,1019,56.611111111111114,0
1,1,936,1180,17,0.7925486875529213,2116,117.55555555555556,0
0,1,467,1579,4,0.2955696202531646,2046,409.2,0
1,2,704,1757,16,0.4004550625711035,2461,144.76470588235293,0
2,0,1051,584,9,1.7965811965811966,1635,163.5,0
2,0,3129,404,36,7.725925925925926,3533,95.48648648648648,0
0,3,1447,657,0,2.1990881458966567,2104,2104.0,1
2,1,519,411,3,1.2597087378640777,930,232.5,0
2,0,1379,220,75,6.239819004524887,1599,21.039473684210527,0
2,1,2989,313,17,9.519108280254777,3302,183.44444444444446,0
0,3,691,211,5,3.259433962264151,902,150.33333333333334,0
0,1,528,251,47,2.0952380952380953,779,16.229166666666668,0
2,0,81,78,57,1.0253164556962024,159,2.7413793103448274,0
1,1,2229,444,7,5.008988764044944,2673,334.125,0
2,0,282,214,37,1.3116279069767443,496,13.052631578947368,0
0,3,66,475,28,0.13865546218487396,541,18.655172413793103,0
0,1,770,1256,41,0.6125696101829753,2026,48.23809523809524,0
0,0,1870,475,46,3.9285714285714284,2345,49.8936170212766,1
2,3,521,2474,32,0.2105050505050505,2995,90.75757575757575,0
1,1,1528,127,93,11.9375,1655,17.606382978723403,0
0,3,1810,1519,59,1.1907894736842106,3329,55.483333333333334,0
0,0,605,228,7,2.6419213973799125,833,104.125,0
2,1,893,2173,73,0.4107635694572217,3066,41.432432432432435,0
1,1,763,206,13,3.685990338164251,969,69.21428571428571,0
2,1,2800,1099,38,2.5454545454545454,3899,99.97435897435898,0
0,3,1292,51,56,24.846153846153847,1343,23.56140350877193,1
1,3,2594,794,17,3.2628930817610065,3388,188.22222222222223,0
1,0,248,197,1,1.2525252525252526,445,222.5,0
0,2,371,887,89,0.4177927927927928,1258,13.977777777777778,0
1,1,73,808,2,0.09023485784919653,881,293.6666666666667,0
1,1,692,2058,12,0.3360854783875668,2750,211.53846153846155,0
2,0,2070,788,27,2.623574144486692,2858,102.07142857142857,0
0,1,395,419,3,0.9404761904761905,814,203.5,0
0,3,137,172,54,0.791907514450867,309,5.618181818181818,0
0,3,70,857,6,0.08158508158508158,927,132.42857142857142,0
0,1,593,98,128,5.98989898989899,691,5.3565891472868215,0
0,1,179,1410,74,0.1268603827072998,1589,21.186666666666667,0
1,3,424,227,27,1.8596491228070176,651,23.25,0
2,1,1714,594,32,2.880672268907563,2308,69.93939393939394,0
0,3,484,724,22,0.6675862068965517,1208,52.52173913043478,0
2,2,941,360,14,2.6066481994459836,1301,86.73333333333333,0
2,2,697,872,13,0.7983963344788088,1569,112.07142857142857,0
1,1,1267,230,66,5.484848484848484,1497,22.34328358208955,0
0,1,169,28,25,5.827586206896552,197,7.576923076923077,0
1,1,2531,2560,51,0.9882858258492776,5091,97.90384615384616,1
0,3,1031,308,21,3.336569579288026,1339,60.86363636363637,0
1,2,316,999,11,0.316,1315,109.58333333333333,0
2,2,131,566,2,0.2310405643738977,697,232.33333333333334,0
0,0,162,884,11,0.18305084745762712,1046,87.16666666666667,0
2,0,1526,94,63,16.063157894736843,1620,25.3125,1
2,1,886,585,37,1.5119453924914676,1471,38.71052631578947,0
1,3,479,398,46,1.200501253132832,877,18.659574468085108,0
0,1,404,480,44,0.83991683991684,884,19.644444444444446,0
2,2,1936,2710,3,0.7141276281814829,4646,1161.5,0
1,1,2077,117,5,17.60169491525424,2194,365.6666666666667,0
0,1,870,1124,11,0.7733333333333333,1994,166.16666666666666,0
0,2,743,320,10,2.3146417445482865,1063,96.63636363636364,0
2,2,1695,274,2,6.163636363636364,1969,656.3333333333334,0
0,2,1383,252,4,5.466403162055336,1635,327.0,1
2,2,511,343,58,1.4854651162790697,854,14.474576271186441,0
0,0,86,353,26,0.24293785310734464,439,16.25925925925926,0
1,3,1463,252,12,5.782608695652174,1715,131.92307692307693,1
2,3,184,880,22,0.20885357548240635,1064,46.26086956521739,0
2,2,16,39,9,0.4,55,5.5,0
0,3,1853,323,26,5.719135802469136,2176,80.5925925925926,0
0,3,863,263,2,3.268939393939394,1126,375.3333333333333,0
2,3,2222,1113,69,1.9946140035906643,3335,47.642857142857146,0
0,3,662,126,8,5.21259842519685,788,87.55555555555556,0
1,2,2610,2259,51,1.154867256637168,4869,93.63461538461539,0
0,1,436,149,32,2.9066666666666667,585,17.727272727272727,0
1,1,1289,369,22,3.483783783783784,1658,72.08695652173913,1
1,1,358,178,79,2.0,536,6.7,0
1,0,1,270,5,0.0036900369003690036,271,45.166666666666664,0
1,3,477,1145,3,0.4162303664921466,1622,405.5,0
1,2,1338,517,11,2.583011583011583,1855,154.58333333333334,0
0,2,162,141,53,1.1408450704225352,303,5.611111111111111,0
1,0,702,38,1,18.0,740,370.0,1
0,2,238,209,8,1.1333333333333333,447,49.666666666666664,0
1,1,77,2329,16,0.03304721030042918,2406,141.52941176470588,0
2,0,960,1493,37,0.642570281124498,2453,64.55263157894737,0
1,2,3035,464,10,6.526881720430108,3499,318.09090909090907,0
2,0,372,526,17,0.7058823529411765,898,49.888888888888886,0
1,0,869,1837,12,0.47279651795429817,2706,208.15384615384616,0
1,2,3070,715,2,4.287709497206704,3785,1261.6666666666667,0
1,1,1051,1701,40,0.617508813160987,2752,67.1219512195122,0
2,2,1118,541,18,2.062730627306273,1659,87.3157894736842,0
2,3,197,178,50,1.100558659217877,375,7.352941176470588,0
1,3,678,1035,35,0.6544401544401545,1713,47.583333333333336,0
0,2,457,597,1,0.7642140468227425,1054,527.0,0
1,1,636,883,20,0.7194570135746606,1519,72.33333333333333,0
2,3,1613,136,140,11.773722627737227,1749,12.404255319148936,0
1,3,617,834,11,0.7389221556886227,1451,120.91666666666667,0
2,2,64,385,20,0.16580310880829016,449,21.38095238095238,0
2,2,2359,322,31,7.303405572755418,2681,83.78125,0
2,2,787,890,6,0.8832772166105499,1677,239.57142857142858,0
1,0,2583,717,36,3.597493036211699,3300,89.1891891891892,0
2,0,849,837,32,1.0131264916467781,1686,51.09090909090909,0
2,0,72,2689,14,0.026765799256505577,2761,184.06666666666666,0
1,2,804,966,10,0.8314374353671148,1770,160.9090909090909,0
2,1,857,819,75,1.0451219512195122,1676,22.05263157894737,0
1,3,241,760,4,0.316688567674113,1001,200.2,0
2,0,636,406,16,1.5626535626535627,1042,61.294117647058826,0
0,1,615,1462,43,0.4203691045796309,2077,47.20454545454545,0
0,2,975,383,4,2.5390625,1358,271.6,0
2,0,300,963,81,0.3112033195020747,1263,15.402439024390244,0
0,2,871,277,22,3.133093525179856,1148,49.91304347826087,0
1,1,275,127,21,2.1484375,402,18.272727272727273,0
0,0,591,111,16,5.276785714285714,702,41.294117647058826,0
2,0,130,805,60,0.16129032258064516,935,15.327868852459016,0
2,0,38,317,88,0.11949685534591195,355,3.9887640449438204,0
1,0,386,257,14,1.496124031007752,643,42.86666666666667,0
2,1,320,717,23,0.4456824512534819,1037,43.208333333333336,0
1,0,522,20,11,24.857142857142858,542,45.166666666666664,0
0,3,3269,226,13,14.400881057268723,3495,249.64285714285714,0
0,3,738,333,0,2.2095808383233533,1071,1071.0,0
1,2,805,985,46,0.8164300202839757,1790,38.08510638297872,0
1,0,2840,629,104,4.507936507936508,3469,33.03809523809524,1
2,3,2540,1550,44,1.6376531270148291,4090,90.88888888888889,0
0,3,2155,325,21,6.610429447852761,2480,112.72727272727273,0
1,3,103,281,52,0.36524822695035464,384,7.245283018867925,0
0,1,1005,27,58,35.892857142857146,1032,17.491525423728813,0
1,0,1650,2424,23,0.6804123711340206,4074,169.75,0
0,1,1805,556,83,3.2405745062836626,2361,28.107142857142858,0
2,1,862,558,0,1.5420393559928445,1420,1420.0,0
0,3,17,2055,0,0.008268482490272374,2072,2072.0,1
0,3,3638,273,2,13.277372262773723,3911,1303.6666666666667,0
0,2,639,322,1,1.978328173374613,961,480.5,0
0,0,500,854,16,0.5847953216374269,1354,79.6470588235294,0
0,0,502,1230,84,0.40779853777416736,1732,20.376470588235293,0
2,3,551,961,33,0.5727650727650727,1512,44.470588235294116,0
1,3,277,1243,32,0.22266881028938906,1520,46.06060606060606,0
0,0,396,684,14,0.5781021897810219,1080,72.0,0
2,2,4223,1589,22,2.6559748427672956,5812,252.69565217391303,0
0,3,459,638,10,0.7183098591549296,1097,99.72727272727273,0
0,2,748,208,21,3.5789473684210527,956,43.45454545454545,0
1,1,1885,624,41,3.016,2509,59.73809523809524,0
0,3,749,998,24,0.7497497497497497,1747,69.88,0
2,1,392,848,16,0.4617196702002356,1240,72.94117647058823,0
2,3,741,222,55,3.3228699551569507,963,17.196428571428573,0
1,1,121,33,10,3.5588235294117645,154,14.0,0
0,3,139,232,19,0.5965665236051502,371,18.55,0
2,2,1184,3310,114,0.35759589247961343,4494,39.07826086956522,0
0,2,2494,163,102,15.207317073170731,2657,25.796116504854368,0
0,2,1293,499,0,2.586,1792,1792.0,0
0,1,77,813,22,0.0945945945945946,890,38.69565217391305,0
1,2,515,1692,12,0.30419373892498525,2207,169.76923076923077,0
0,1,2,1142,10,0.0017497812773403325,1144,104.0,0
2,3,715,1917,27,0.3727841501564129,2632,94.0,0
0,1,214,741,17,0.2884097035040431,955,53.05555555555556,0
2,3,2026,1603,39,1.2630922693266833,3629,90.725,0
0,0,110,245,0,0.44715447154471544,355,355.0,0
2,0,1,450,78,0.0022172949002217295,451,5.708860759493671,0
2,0,599,1485,25,0.40309555854643336,2084,80.15384615384616,0
0,1,168,315,34,0.5316455696202531,483,13.8,0
0,0,1339,1639,27,0.8164634146341463,2978,106.35714285714286,0
2,0,2524,360,135,6.991689750692521,2884,21.205882352941178,0
1,0,42,361,128,0.11602209944751381,403,3.124031007751938,0
0,3,503,295,28,1.6993243243243243,798,27.517241379310345,0
1,2,5749,633,34,9.06782334384858,6382,182.34285714285716,1
0,1,1319,110,28,11.882882882882884,1429,49.275862068965516,0
0,0,3061,29,11,102.03333333333333,3090,257.5,0
0,3,179,1821,6,0.0982436882546652,2000,285.7142857142857,0
0,2,250,2115,15,0.11814744801512288,2365,147.8125,0
1,2,168,63,34,2.625,231,6.6,0
0,2,360,638,1,0.5633802816901409,998,499.0,0
2,3,1288,620,21,2.074074074074074,1908,86.72727272727273,0
2,0,180,372,15,0.48257372654155495,552,34.5,0
1,2,742,673,22,1.1008902077151335,1415,61.52173913043478,0
0,3,313,490,59,0.6374745417515275,803,13.383333333333333,0
2,3,1767,538,1,3.2782931354359928,2305,1152.5,0
1,1,6,1126,43,0.005323868677905945,1132,25.727272727272727,0
0,3,252,597,32,0.4214046822742475,849,25.727272727272727,0
2,2,929,312,6,2.9680511182108624,1241,177.28571428571428,0
2,2,101,696,39,0.1449067431850789,797,19.925,0
1,3,627,818,20,0.7655677655677655,1445,68.80952380952381,0
0,2,573,868,19,0.6593785960874569,1441,72.05,0
0,3,1914,770,19,2.482490272373541,2684,134.2,0
2,2,981,873,89,1.1224256292906178,1854,20.6,0
2,1,1020,296,86,3.4343434343434343,1316,15.126436781609195,0
2,0,3032,472,73,6.41014799154334,3504,47.351351351351354,0
0,1,4037,883,65,4.566742081447964,4920,74.54545454545455,1
1,1,1059,1123,1,0.9421708185053381,2182,1091.0,0
1,0,738,455,15,1.618421052631579,1193,74.5625,0
0,2,936,363,67,2.5714285714285716,1299,19.102941176470587,0
1,0,481,1006,42,0.47765640516385305,1487,34.58139534883721,0
2,3,4378,201,18,21.673267326732674,4579,241.0,1
1,0,1220,7,44,152.5,1227,27.266666666666666,0
1,1,343,509,7,0.6725490196078432,852,106.5,0
1,0,59,152,27,0.38562091503267976,211,7.535714285714286,0
2,2,45,380,22,0.11811023622047244,425,18.47826086956522,0
0,1,229,275,25,0.8297101449275363,504,19.384615384615383,0
2,3,265,1201,38,0.22046589018302828,1466,37.58974358974359,0
0,2,536,322,89,1.6594427244582044,858,9.533333333333333,0
0,1,241,818,9,0.29426129426129427,1059,105.9,0
0,3,996,896,42,1.1103678929765886,1892,44.0,0
1,2,237,487,31,0.48565573770491804,724,22.625,0
1,3,208,67,35,3.0588235294117645,275,7.638888888888889,1
0,0,637,964,16,0.6601036269430052,1601,94.17647058823529,0
0,0,2195,62,86,34.84126984126984,2257,25.942528735632184,1
1,3,631,83,19,7.511904761904762,714,35.7,1
2,0,534,174,3,3.0514285714285716,708,177.0,0
0,3,862,263,34,3.265151515151515,1125,32.142857142857146,0
2,2,297,1498,4,0.1981320880587058,1795,359.0,0
1,1,436,898,11,0.4849833147942158,1334,111.16666666666667,0
0,3,240,391,7,0.6122448979591837,631,78.875,0
2,1,848,3076,23,0.2755931101722457,3924,163.5,0
2,1,1195,223,12,5.334821428571429,1418,109.07692307692308,0
2,3,1119,752,5,1.4860557768924303,1871,311.8333333333333,0
1,0,294,1502,46,0.19560878243512975,1796,38.212765957446805,0
1,2,1512,1295,18,1.1666666666666667,2807,147.73684210526315,0
2,1,295,75,18,3.8815789473684212,370,19.473684210526315,0
2,2,162,955,65,0.1694560669456067,1117,16.924242424242426,0
1,1,430,238,23,1.799163179916318,668,27.833333333333332,0
2,3,910,351,37,2.585227272727273,1261,33.18421052631579,0
2,0,153,537,11,0.2843866171003718,690,57.5,0
1,2,1044,1251,24,0.8338658146964856,2295,91.8,0
2,1,1988,145,38,13.616438356164384,2133,54.69230769230769,0
2,3,346,91,10,3.760869565217391,437,39.72727272727273,1
2,3,598,133,34,4.462686567164179,731,20.885714285714286,0
1,1,259,196,25,1.3147208121827412,455,17.5,0
2,1,448,49,17,8.96,497,27.61111111111111,0
1,1,22,2086,37,0.010541447053186392,2108,55.473684210526315,0
1,0,3074,307,11,9.980519480519481,3381,281.75,0
0,1,537,155,37,3.4423076923076925,692,18.210526315789473,0
0,1,1555,812,24,1.912669126691267,2367,94.68,0
2,0,153,1237,8,0.12358642972536349,1390,154.44444444444446,0
1,3,1673,1119,33,1.49375,2792,82.11764705882354,0
0,1,1967,1014,64,1.9379310344827587,2981,45.86153846153846,0
2,2,1256,41,11,29.904761904761905,1297,108.08333333333333,0
0,3,2335,1219,50,1.9139344262295082,3554,69.68627450980392,0
0,2,182,557,12,0.32616487455197135,739,56.84615384615385,0
1,1,647,837,51,0.7720763723150358,1484,28.53846153846154,0
1,0,967,2506,1,0.3857199840446749,3473,1736.5,0
0,0,906,1331,0,0.6801801801801802,2237,2237.0,1
0,0,1973,1396,3,1.4123120973514673,3369,842.25,0
1,1,242,160,62,1.5031055900621118,402,6.380952380952381,0
2,1,193,517,22,0.37258687258687256,710,30.869565217391305,0
1,2,292,2385,27,0.12238055322715842,2677,95.60714285714286,0
0,0,2221,699,55,3.172857142857143,2920,52.142857142857146,0
2,1,2830,86,1,32.52873563218391,2916,1458.0,1
0,3,843,1052,14,0.8005698005698005,1895,126.33333333333333,0
2,1,695,35,30,19.305555555555557,730,23.548387096774192,1
0,1,929,1084,15,0.8562211981566821,2013,125.8125,0
2,3,957,1694,0,0.5646017699115045,2651,2651.0,1
2,0,186,443,31,0.4189189189189189,629,19.65625,0
0,3,1159,427,14,2.707943925233645,1586,105.73333333333333,0
2,0,602,290,0,2.06872852233677,892,892.0,0
1,3,728,1676,5,0.43410852713178294,2404,400.6666666666667,0
0,2,30,634,7,0.047244094488188976,664,83.0,0
1,0,1446,692,21,2.0865800865800868,2138,97.18181818181819,0
0,1,1804,867,6,2.078341013824885,2671,381.57142857142856,0
2,2,966,285,13,3.3776223776223775,1251,89.35714285714286,0
2,0,1381,453,41,3.041850220264317,1834,43.666666666666664,0
2,0,739,1082,49,0.6823638042474608,1821,36.42,0
0,0,963,3386,47,0.2843224092116918,4349,90.60416666666667,1
1,3,501,27,35,17.892857142857142,528,14.666666666666666,0
1,0,1569,34,23,44.82857142857143,1603,66.79166666666667,0
0,1,631,447,23,1.4084821428571428,1078,44.916666666666664,0
0,0,1140,862,91,1.320973348783314,2002,21.76086956521739,0
1,1,971,390,63,2.483375959079284,1361,21.265625,0
1,1,1211,6340,31,0.1909793407979814,7551,235.96875,0
1,1,1538,173,18,8.839080459770114,1711,90.05263157894737,1
1,2,718,6,39,102.57142857142857,724,18.1,0
0,1,1676,168,1,9.91715976331361,1844,922.0,0
0,3,687,1743,86,0.39392201834862384,2430,27.93103448275862,0
2,0,3138,125,23,24.904761904761905,3263,135.95833333333334,0
1,3,1397,521,20,2.6762452107279695,1918,91.33333333333333,0
2,2,187,434,10,0.4298850574712644,621,56.45454545454545,0
0,0,1769,876,0,2.0171037628278223,2645,2645.0,0
0,1,802,44,1,17.822222222222223,846,423.0,1
2,0,4164,860,9,4.83623693379791,5024,502.4,1
1,2,1268,350,23,3.6125356125356127,1618,67.41666666666667,1
1,2,88,2083,2,0.04222648752399232,2171,723.6666666666666,0
1,3,502,1511,107,0.33201058201058203,2013,18.63888888888889,0
1,0,728,408,15,1.7799511002444988,1136,71.0,0
2,0,1826,3957,11,0.461344113188479,5783,481.9166666666667,1
2,0,1306,42,22,30.372093023255815,1348,58.608695652173914,0
0,3,461,1243,2,0.37057877813504825,1704,568.0,0
1,2,1059,455,57,2.3223684210526314,1514,26.103448275862068,0
1,1,860,454,18,1.89010989010989,1314,69.15789473684211,0
1,0,134,149,5,0.8933333333333333,283,47.166666666666664,0
2,3,267,578,5,0.46113989637305697,845,140.83333333333334,0
1,3,417,70,13,5.873239436619718,487,34.785714285714285,1
2,1,217,766,25,0.28292046936114734,983,37.80769230769231,0
1,2,162,221,16,0.7297297297297297,383,22.529411764705884,0
1,0,59,1032,27,0.057115198451113264,1091,38.964285714285715,0
0,0,2064,747,36,2.7593582887700534,2811,75.97297297297297,0
1,3,341,1097,41,0.3105646630236794,1438,34.23809523809524,0
1,2,342,1108,15,0.3083859332732191,1450,90.625,0
0,0,230,175,37,1.3068181818181819,405,10.657894736842104,0
2,1,645,0,4,645.0,645,129.0,0
2,2,722,364,21,1.978082191780822,1086,49.36363636363637,0
1,2,233,2011,2,0.11580516898608349,2244,748.0,0
2,3,937,690,8,1.3560057887120116,1627,180.77777777777777,0
1,3,1283,1040,26,1.2324687800192122,2323,86.03703703703704,0
0,0,468,1693,40,0.2762691853600944,2161,52.707317073170735,0
0,3,880,1892,3,0.4648705758055996,2772,693.0,0
1,2,697,602,6,1.1558872305140961,1299,185.57142857142858,0
0,0,217,622,144,0.34831460674157305,839,5.786206896551724,0
0,0,1309,1522,12,0.8594878529218647,2831,217.76923076923077,0
1,2,1616,1318,10,1.2251705837755875,2934,266.72727272727275,0
1,0,1046,960,2,1.0884495317377731,2006,668.6666666666666,0
0,1,391,742,35,0.5262449528936743,1133,31.47222222222222,0
2,1,2614,768,21,3.399219765929779,3382,153.72727272727272,1
2,0,607,360,5,1.6814404432132963,967,161.16666666666666,0
1,3,309,1470,30,0.21006118286879674,1779,57.38709677419355,0
1,1,524,769,22,0.6805194805194805,1293,56.21739130434783,0
2,0,1177,202,24,5.798029556650246,1379,55.16,0
0,1,1870,219,158,8.5,2089,13.138364779874214,0
2,3,440,1582,0,0.2779532533164877,2022,2022.0,0
2,2,264,786,73,0.3354510800508259,1050,14.18918918918919,0
2,0,984,406,55,2.4176904176904177,1390,24.821428571428573,0
2,0,2541,165,16,15.30722891566265,2706,159.1764705882353,1
1,0,202,753,63,0.26790450928381965,955,14.921875,0
1,0,1624,162,31,9.963190184049079,1786,55.8125,1
0,0,647,508,66,1.2711198428290766,1155,17.238805970149254,0
0,0,1607,905,27,1.7737306843267109,2512,89.71428571428571,0
0,3,704,666,7,1.055472263868066,1370,171.25,0
0,2,473,2041,25,0.2316356513222331,2514,96.6923076923077,0
2,3,1193,32,5,36.15151515151515,1225,204.16666666666666,0
1,3,2308,262,4,8.775665399239545,2570,514.0,0
1,2,386,47,31,8.041666666666666,433,13.53125,0
0,3,617,173,88,3.545977011494253,790,8.876404494382022,0
0,1,260,105,26,2.452830188679245,365,13.518518518518519,0
2,3,202,1055,47,0.19128787878787878,1257,26.1875,0
2,0,1504,368,5,4.075880758807588,1872,312.0,0
0,1,223,2072,31,0.1075735648818138,2295,71.71875,0
1,1,1576,18,39,82.94736842105263,1594,39.85,0
1,2,560,846,1,0.6611570247933884,1406,703.0,0
1,3,5308,2819,3,1.8822695035460992,8127,2031.75,0
0,3,219,154,45,1.4129032258064516,373,8.108695652173912,0
1,1,97,467,17,0.20726495726495728,564,31.333333333333332,0
2,3,78,968,15,0.0804953560371517,1046,65.375,0
2,3,1804,802,75,2.2465753424657535,2606,34.28947368421053,0
0,2,575,667,144,0.8607784431137725,1242,8.565517241379311,0
2,1,3,316,43,0.00946372239747634,319,7.25,0
0,0,2077,1042,47,1.9913710450623203,3119,64.97916666666667,0
1,1,2094,847,7,2.4693396226415096,2941,367.625,0
1,2,1642,142,6,11.482517482517483,1784,254.85714285714286,1
1,2,285,2661,118,0.10706235912847484,2946,24.756302521008404,0
2,2,466,648,35,0.7180277349768875,1114,30.944444444444443,0
0,3,1366,596,34,2.288107202680067,1962,56.05714285714286,0
1,1,672,1508,10,0.44532803180914515,2180,198.1818181818182,0
0,3,167,818,65,0.2039072039072039,985,14.924242424242424,0
1,3,278,61,1,4.483870967741935,339,169.5,0
2,1,3596,565,9,6.353356890459364,4161,416.1,0
2,2,163,1213,5,0.1342668863261944,1376,229.33333333333334,0
0,0,1294,963,37,1.342323651452282,2257,59.39473684210526,0
2,0,650,2826,37,0.22992571630703926,3476,91.47368421052632,0
2,1,1380,20,22,65.71428571428571,1400,60.869565217391305,0
0,1,1082,242,0,4.4526748971193415,1324,1324.0,0
1,2,578,637,62,0.9059561128526645,1215,19.285714285714285,0
2,1,436,772,93,0.5640362225097024,1208,12.851063829787234,0
0,1,1403,256,6,5.4591439688715955,1659,237.0,0
2,2,390,1402,55,0.27797576621525305,1792,32.0,0
2,2,1550,143,108,10.76388888888889,1693,15.53211009174312,0
2,3,1138,0,11,1138.0,1138,94.83333333333333,0
2,1,861,2435,6,0.35344827586206895,3296,470.85714285714283,0
0,0,460,397,113,1.1557788944723617,857,7.517543859649122,0
0,1,229,2526,1,0.09062129006727344,2755,1377.5,0
0,0,1239,260,9,4.747126436781609,1499,149.9,0
2,0,95,52,40,1.7924528301886793,147,3.5853658536585367,0
2,0,3524,1184,28,2.9738396624472574,4708,162.3448275862069,1
2,3,3851,1445,34,2.6632088520055324,5296,151.31428571428572,1
0,2,139,541,36,0.2564575645756458,680,18.37837837837838,0
2,2,109,61,34,1.7580645161290323,170,4.857142857142857,0
1,3,532,849,12,0.6258823529411764,1381,106.23076923076923,0
2,2,3315,160,11,20.59006211180124,3475,289.5833333333333,0
1,3,511,1514,16,0.3372937293729373,2025,119.11764705882354,0
2,1,452,256,49,1.7587548638132295,708,14.16,0
0,3,1215,1505,83,0.8067729083665338,2720,32.38095238095238,0
2,2,196,445,18,0.43946188340807174,641,33.73684210526316,0
1,2,451,726,2,0.6203576341127923,1177,392.3333333333333,0
1,1,344,1246,83,0.27586206896551724,1590,18.928571428571427,0
2,3,920,33,2,27.058823529411764,953,317.6666666666667,1
1,1,177,1377,5,0.12844702467343977,1554,259.0,0
1,0,795,119,60,6.625,914,14.98360655737705,0
0,3,1948,355,24,5.47191011235955,2303,92.12,1
2,1,721,512,13,1.405458089668616,1233,88.07142857142857,0
2,1,1150,1806,80,0.6364139457664637,2956,36.49382716049383,0
2,2,78,18,96,4.105263157894737,96,0.9896907216494846,0
1,3,596,655,12,0.9085365853658537,1251,96.23076923076923,0
2,0,99,822,60,0.12029161603888214,921,15.098360655737705,0
2,0,914,304,34,2.99672131147541,1218,34.8,0
0,3,329,274,9,1.1963636363636363,603,60.3,0
0,3,338,539,85,0.6259259259259259,877,10.19767441860465,0
0,1,79,165,1,0.4759036144578313,244,122.0,0
1,2,371,505,11,0.733201581027668,876,73.0,0
2,2,706,1158,15,0.6091458153580673,1864,116.5,0
0,2,878,1493,35,0.5876840696117804,2371,65.86111111111111,0
0,3,68,389,1,0.17435897435897435,457,228.5,0
0,2,1053,768,66,1.3693107932379713,1821,27.17910447761194,0
2,1,671,0,32,671.0,671,20.333333333333332,1
2,3,769,639,9,1.2015625,1408,140.8,0
2,3,1788,2958,32,0.6042581953362622,4746,143.8181818181818,0
1,2,418,299,23,1.3933333333333333,717,29.875,0
1,0,191,722,12,0.2641770401106501,913,70.23076923076923,0
0,0,802,1149,0,0.697391304347826,1951,1951.0,1
2,1,2900,751,24,3.856382978723404,3651,146.04,0
0,2,729,433,2,1.6797235023041475,1162,387.3333333333333,0
2,2,1783,132,49,13.406015037593985,1915,38.3,1
2,3,1414,498,2,2.8336673346693386,1912,637.3333333333334,0
2,3,730,279,16,2.607142857142857,1009,59.35294117647059,0
1,2,1042,952,17,1.093389296956978,1994,110.77777777777777,0
1,3,522,466,24,1.1177730192719486,988,39.52,0
2,2,756,1517,1,0.4980237154150198,2273,1136.5,0
0,1,707,171,6,4.1104651162790695,878,125.42857142857143,0
2,3,1234,432,6,2.8498845265588915,1666,238.0,0
2,2,527,652,27,0.8070444104134763,1179,42.107142857142854,0
0,3,105,107,9,0.9722222222222222,212,21.2,0
2,1,1554,709,4,2.1887323943661974,2263,452.6,0
0,3,1154,275,0,4.181159420289855,1429,1429.0,1
1,2,2998,208,55,14.344497607655502,3206,57.25,1
1,3,559,122,106,4.544715447154472,681,6.364485981308412,0
0,3,81,344,36,0.23478260869565218,425,11.486486486486486,0
1,2,129,2115,15,0.0609640831758034,2244,140.25,0
1,0,1484,25,3,57.07692307692308,1509,377.25,0
0,3,70,1529,19,0.0457516339869281,1599,79.95,0
1,3,2384,405,18,5.87192118226601,2789,146.78947368421052,0
2,1,330,659,16,0.5,989,58.1764705882353,0
2,0,2291,575,14,3.9774305555555554,2866,191.06666666666666,0
0,1,1485,2080,20,0.7135992311388756,3565,169.76190476190476,0
1,2,2049,1176,2,1.7408666100254886,3225,1075.0,0
2,2,240,3350,1,0.07162041181736795,3590,1795.0,0
2,1,905,1265,1,0.7148499210110585,2170,1085.0,0
1,3,98,280,6,0.3487544483985765,378,54.0,0
1,0,225,2634,9,0.08538899430740038,2859,285.9,0
2,1,370,3286,5,0.11256464861575904,3656,609.3333333333334,0
2,1,1350,105,8,12.735849056603774,1455,161.66666666666666,0
0,2,25,1850,6,0.01350621285791464,1875,267.85714285714283,0
0,3,2334,872,4,2.6735395189003435,3206,641.2,0
2,0,73,2040,10,0.03576678098971093,2113,192.0909090909091,0
0,1,472,1979,15,0.2383838383838384,2451,153.1875,0
2,0,84,1775,40,0.0472972972972973,1859,45.34146341463415,0
2,0,1465,1732,93,0.8453548759376803,3197,34.01063829787234,0
0,1,152,100,75,1.504950495049505,252,3.3157894736842106,0
0,0,2160,123,19,17.419354838709676,2283,114.15,0
1,2,755,100,18,7.475247524752476,855,45.0,0
1,3,2965,76,4,38.506493506493506,3041,608.2,1
1,3,342,348,106,0.9799426934097422,690,6.4485981308411215,0
2,3,605,921,42,0.6561822125813449,1526,35.48837209302326,0
0,2,1184,350,56,3.3732193732193734,1534,26.912280701754387,0
2,2,1783,1019,8,1.7480392156862745,2802,311.3333333333333,0
0,2,547,1373,15,0.39810771470160117,1920,120.0,0
2,3,2229,877,3,2.5387243735763096,3106,776.5,0
1,0,125,500,84,0.249500998003992,625,7.352941176470588,0
1,2,1233,280,10,4.387900355871886,1513,137.54545454545453,0
1,1,428,106,27,4.0,534,19.071428571428573,0
2,2,106,544,4,0.1944954128440367,650,130.0,0
0,1,488,1017,48,0.4793713163064833,1505,30.714285714285715,0
0,3,2122,635,6,3.3364779874213837,2757,393.85714285714283,0
1,1,3939,1022,49,3.8504398826979473,4961,99.22,1
1,2,498,326,15,1.5229357798165137,824,51.5,0
1,2,2175,55,25,38.839285714285715,2230,85.76923076923077,1
1,0,712,1179,9,0.6033898305084746,1891,189.1,0
0,3,1262,198,64,6.341708542713568,1460,22.46153846153846,1
2,1,46,766,42,0.05997392438070404,812,18.88372093023256,0
2,3,814,1304,13,0.6237547892720307,2118,151.28571428571428,0
2,2,72,119,26,0.6,191,7.074074074074074,0
2,0,312,730,4,0.426812585499316,1042,208.4,0
1,2,836,935,5,0.8931623931623932,1771,295.1666666666667,0
1,2,1645,1098,22,1.4968152866242037,2743,119.26086956521739,0
1,2,823,127,30,6.4296875,950,30.64516129032258,0
2,1,2751,1394,24,1.972043010752688,4145,165.8,0
1,2,1662,79,24,20.775,1741,69.64,0
1,3,169,586,40,0.2879045996592845,755,18.414634146341463,0
0,3,492,468,69,1.049040511727079,960,13.714285714285714,0
0,0,1104,200,14,5.492537313432836,1304,86.93333333333334,0
1,3,2787,287,23,9.677083333333334,3074,128.08333333333334,0
0,2,4399,143,67,30.54861111111111,4542,66.79411764705883,1
0,2,1440,443,18,3.2432432432432434,1883,99.10526315789474,0
1,3,852,28,17,29.379310344827587,880,48.888888888888886,0
1,0,1413,1757,43,0.8037542662116041,3170,72.04545454545455,0
1,0,319,142,62,2.230769230769231,461,7.317460317460317,0
1,3,333,1737,40,0.1915995397008055,2070,50.48780487804878,0
2,1,1062,1593,3,0.6662484316185696,2655,663.75,0
2,1,2054,480,18,4.27027027027027,2534,133.3684210526316,0
1,1,3500,550,7,6.352087114337568,4050,506.25,0
0,1,417,287,11,1.4479166666666667,704,58.666666666666664,0
1,3,1592,4614,18,0.3449620801733478,6206,326.63157894736844,0
1,0,1907,888,7,2.1451068616422946,2795,349.375,0
0,2,975,2426,21,0.40173053152039556,3401,154.5909090909091,0
2,2,427,428,30,0.9953379953379954,855,27.580645161290324,0
1,3,965,1716,62,0.5620267909143856,2681,42.55555555555556,0
1,2,878,475,7,1.8445378151260505,1353,169.125,0
2,1,932,1612,11,0.5778053316800992,2544,212.0,0
2,0,965,112,15,8.539823008849558,1077,67.3125,1
0,3,1877,810,7,2.31442663378545,2687,335.875,0
2,0,186,908,12,0.20462046204620463,1094,84.15384615384616,0
2,3,457,854,64,0.5345029239766081,1311,20.16923076923077,0
2,3,881,473,4,1.858649789029536,1354,270.8,0
0,3,333,921,17,0.3611713665943601,1254,69.66666666666667,0
2,3,3823,218,11,17.45662100456621,4041,336.75,1
2,0,305,724,2,0.4206896551724138,1029,343.0,0
0,2,634,646,3,0.9799072642967542,1280,320.0,0
2,3,2098,306,46,6.833876221498372,2404,51.148936170212764,1
2,1,83,1207,57,0.06870860927152318,1290,22.24137931034483,0
0,3,1718,67,40,25.264705882352942,1785,43.53658536585366,0
1,0,846,150,23,5.602649006622516,996,41.5,0
0,3,32,509,44,0.06274509803921569,541,12.022222222222222,0
2,1,2332,1778,4,1.3108487914558742,4110,822.0,0
2,0,39,684,45,0.05693430656934306,723,15.717391304347826,0
2,3,724,1476,16,0.4901828029790115,2200,129.41176470588235,0
0,1,50,583,41,0.08561643835616438,633,15.071428571428571,0
2,0,73,1231,7,0.05925324675324675,1304,163.0,0
2,3,2182,315,53,6.905063291139241,2497,46.24074074074074,0
0,1,1451,1350,25,1.074019245003701,2801,107.73076923076923,0
1,0,219,410,0,0.5328467153284672,629,629.0,0
1,3,968,654,21,1.4778625954198474,1622,73.72727272727273,0
2,0,1583,154,11,10.212903225806452,1737,144.75,1
0,1,2203,2024,1,1.0879012345679013,4227,2113.5,0
2,3,631,967,17,0.6518595041322314,1598,88.77777777777777,0
0,3,2277,1566,11,1.4530950861518825,3843,320.25,0
0,3,708,186,6,3.786096256684492,894,127.71428571428571,0
1,1,1165,56,12,20.43859649122807,1221,93.92307692307692,1
1,2,3864,329,5,11.709090909090909,4193,698.8333333333334,0
0,3,269,581,10,0.46219931271477666,850,77.27272727272727,0
2,1,184,1297,3,0.14175654853620956,1481,370.25,0
1,0,418,405,2,1.0295566502463054,823,274.3333333333333,0
2,0,179,251,72,0.7103174603174603,430,5.890410958904109,0
1,1,334,372,69,0.8954423592493298,706,10.085714285714285,0
1,2,1358,972,52,1.39568345323741,2330,43.9622641509434,0
2,1,649,327,7,1.978658536585366,976,122.0,0
1,0,470,3096,38,0.1517597675169519,3566,91.43589743589743,0
1,0,460,153,26,2.987012987012987,613,22.703703703703702,0
2,3,216,1119,1,0.19285714285714287,1335,667.5,0
1,2,593,711,68,0.8328651685393258,1304,18.89855072463768,0
1,1,979,212,186,4.596244131455399,1191,6.3689839572192515,1
1,0,149,1120,37,0.13291703835860838,1269,33.39473684210526,0
2,0,3605,474,7,7.589473684210526,4079,509.875,0
0,0,585,917,24,0.6372549019607843,1502,60.08,0
2,1,2955,868,3,3.4004602991944766,3823,955.75,1
0,1,144,93,10,1.5319148936170213,237,21.545454545454547,0
1,2,1457,1465,37,0.9938608458390177,2922,76.89473684210526,0
0,3,961,915,10,1.0491266375545851,1876,170.54545454545453,0
2,3,1715,1213,4,1.4126853377265238,2928,585.6,0
2,3,917,475,0,1.9264705882352942,1392,1392.0,0
1,0,3292,173,25,18.919540229885058,3465,133.26923076923077,0
0,3,985,315,103,3.117088607594937,1300,12.5,0
1,0,1535,1853,19,0.8279395900755124,3388,169.4,0
1,2,2100,2224,7,0.9438202247191011,4324,540.5,0
2,0,1253,526,18,2.3776091081593926,1779,93.63157894736842,0
0,2,742,283,27,2.612676056338028,1025,36.607142857142854,0
0,2,318,1048,48,0.3031458531935176,1366,27.877551020408163,0
0,3,1927,1161,18,1.6583476764199656,3088,162.52631578947367,0
0,3,655,1351,5,0.4844674556213018,2006,334.3333333333333,0
1,0,969,25,6,37.26923076923077,994,142.0,0
1,1,82,7,68,10.25,89,1.289855072463768,0
2,3,687,353,8,1.9406779661016949,1040,115.55555555555556,0
1,3,1197,132,39,9.0,1329,33.225,0
1,1,877,1307,9,0.6704892966360856,2184,218.4,0
2,1,595,608,38,0.9770114942528736,1203,30.846153846153847,0
2,3,252,1395,2,0.18051575931232092,1647,549.0,0
2,1,370,155,6,2.371794871794872,525,75.0,0
1,0,1206,789,15,1.5265822784810126,1995,124.6875,0
1,2,253,694,21,0.3640287769784173,947,43.04545454545455,0
2,2,972,332,13,2.918918918918919,1304,93.14285714285714,0
2,3,890,582,25,1.5265866209262435,1472,56.61538461538461,0
2,3,3520,711,11,4.943820224719101,4231,352.5833333333333,0
1,0,62,1762,34,0.03516732841747022,1824,52.114285714285714,0
1,1,114,45,21,2.4782608695652173,159,7.2272727272727275,0
0,3,705,1386,36,0.5082912761355444,2091,56.513513513513516,0
1,2,748,3135,16,0.2385204081632653,3883,228.41176470588235,0
1,0,40,1052,62,0.03798670465337132,1092,17.333333333333332,0
1,0,1747,1069,14,1.6327102803738318,2816,187.73333333333332,0
2,1,682,196,11,3.4619289340101522,878,73.16666666666667,0
1,3,425,592,24,0.7166947723440135,1017,40.68,0
2,3,383,979,21,0.39081632653061227,1362,61.90909090909091,0
0,0,1976,737,21,2.6775067750677506,2713,123.31818181818181,0
0,2,219,389,47,0.5615384615384615,608,12.666666666666666,0
2,3,174,2252,26,0.07723035952063914,2426,89.85185185185185,0
2,2,239,577,64,0.4134948096885813,816,12.553846153846154,0
2,0,980,2801,28,0.3497501784439686,3781,130.3793103448276,0
1,3,1665,663,0,2.5075301204819276,2328,2328.0,0
0,2,401,1261,61,0.31774960380348655,1662,26.806451612903224,0
2,0,190,1083,54,0.1752767527675277,1273,23.145454545454545,0
1,2,234,864,1,0.2705202312138728,1098,549.0,0
0,3,965,11,4,80.41666666666667,976,195.2,0
1,1,282,64,24,4.338461538461538,346,13.84,0
0,2,2097,696,1,3.0086083213773316,2793,1396.5,0
1,1,109,1942,15,0.056098816263510036,2051,128.1875,0
0,3,32,735,111,0.043478260869565216,767,6.848214285714286,0
0,1,92,215,5,0.42592592592592593,307,51.166666666666664,0
1,0,1868,308,6,6.0453074433656955,2176,310.85714285714283,0
2,1,1053,780,33,1.3482714468629962,1833,53.911764705882355,0
0,2,3164,727,1,4.346153846153846,3891,1945.5,0
2,2,409,2493,51,0.1639935846030473,2902,55.80769230769231,0
1,1,239,602,6,0.3963515754560531,841,120.14285714285714,0
2,0,825,350,22,2.3504273504273505,1175,51.08695652173913,0
2,3,771,595,8,1.2936241610738255,1366,151.77777777777777,0
2,1,894,1234,32,0.7238866396761133,2128,64.48484848484848,0
2,2,426,621,26,0.684887459807074,1047,38.77777777777778,0
2,2,5,315,87,0.015822784810126583,320,3.6363636363636362,0
0,1,35,330,17,0.10574018126888217,365,20.27777777777778,0
0,1,1090,1131,62,0.9628975265017667,2221,35.25396825396825,0
0,1,740,55,25,13.214285714285714,795,30.576923076923077,0
1,3,1720,256,73,6.692607003891051,1976,26.7027027027027,0
2,2,357,132,10,2.6842105263157894,489,44.45454545454545,0
0,2,1689,2315,23,0.7292746113989638,4004,166.83333333333334,0
1,2,554,75,14,7.2894736842105265,629,41.93333333333333,0
0,3,101,1135,2,0.08890845070422536,1236,412.0,0
0,0,3812,796,25,4.782936010037641,4608,177.23076923076923,0
2,2,717,801,47,0.8940149625935162,1518,31.625,0
1,2,992,1153,24,0.8596187175043327,2145,85.8,0
2,0,1111,409,9,2.709756097560976,1520,152.0,0
2,3,450,409,9,1.0975609756097562,859,85.9,0
0,0,1376,272,8,5.04029304029304,1648,183.11111111111111,1
2,0,2042,728,116,2.8010973936899863,2770,23.675213675213676,0
1,0,489,2125,15,0.23000940733772343,2614,163.375,0
2,0,1070,2061,11,0.518913676042677,3131,260.9166666666667,0
2,3,1415,971,16,1.455761316872428,2386,140.35294117647058,0
2,3,210,1893,3,0.11087645195353749,2103,525.75,0
0,0,404,2648,6,0.15251038127595318,3052,436.0,0
1,1,115,1268,21,0.09062253743104808,1383,62.86363636363637,0
0,1,921,419,48,2.192857142857143,1340,27.346938775510203,0
0,1,1614,528,62,3.051039697542533,2142,34.0,0
0,1,943,2141,60,0.4402427637721755,3084,50.557377049180324,0
0,2,198,886,86,0.22322435174746336,1084,12.459770114942529,0
0,3,790,1374,4,0.5745454545454546,2164,432.8,0
1,3,1801,98,1,18.19191919191919,1899,949.5,0
2,0,360,172,3,2.0809248554913293,532,133.0,0
0,2,1787,337,27,5.28698224852071,2124,75.85714285714286,0
0,0,1535,166,24,9.191616766467066,1701,68.04,0
1,0,21,1895,33,0.011075949367088608,1916,56.35294117647059,0
1,3,273,195,13,1.3928571428571428,468,33.42857142857143,0
2,2,782,651,14,1.1993865030674846,1433,95.53333333333333,0
1,1,1264,71,23,17.555555555555557,1335,55.625,1
2,3,2124,134,2,15.733333333333333,2258,752.6666666666666,1
0,2,1024,227,48,4.491228070175438,1251,25.53061224489796,0
0,2,478,3254,76,0.14685099846390168,3732,48.467532467532465,0
2,3,204,1275,14,0.15987460815047022,1479,98.6,0
1,3,1427,895,40,1.5926339285714286,2322,56.63414634146341,0
2,0,231,1984,23,0.1163727959697733,2215,92.29166666666667,0
1,0,1188,2502,8,0.4746304434678386,3690,410.0,0
0,0,199,483,2,0.41115702479338845,682,227.33333333333334,0
1,1,95,317,8,0.29874213836477986,412,45.77777777777778,0
2,3,289,303,27,0.9506578947368421,592,21.142857142857142,0
2,2,335,29,1,11.166666666666666,364,182.0,0
0,3,1041,262,54,3.958174904942966,1303,23.69090909090909,0
1,2,175,350,105,0.4985754985754986,525,4.952830188679245,0
1,1,2663,30,2,85.90322580645162,2693,897.6666666666666,1
1,3,808,1713,8,0.47141190198366395,2521,280.1111111111111,0
0,2,675,1506,33,0.44790975447909753,2181,64.1470588235294,0
1,2,570,231,49,2.456896551724138,801,16.02,0
2,0,836,1297,12,0.6440677966101694,2133,164.07692307692307,0
1,1,22,1272,21,0.01728201099764336,1294,58.81818181818182,0
0,3,4613,326,66,14.107033639143731,4939,73.71641791044776,1
1,0,815,955,14,0.852510460251046,1770,118.0,0
1,1,35,273,2,0.12773722627737227,308,102.66666666666667,0
2,0,891,58,158,15.101694915254237,949,5.968553459119497,1
1,3,574,562,5,1.019538188277087,1136,189.33333333333334,0
2,2,24,461,1,0.05194805194805195,485,242.5,0
2,3,2582,118,15,21.69747899159664,2700,168.75,0
0,1,10,539,3,0.018518518518518517,549,137.25,0
2,3,862,2386,115,0.3611227482195224,3248,28.0,0
2,1,3264,1051,14,3.102661596958175,4315,287.6666666666667,1
0,0,271,1074,52,0.25209302325581395,1345,25.37735849056604,0
2,1,293,1133,5,0.2583774250440917,1426,237.66666666666666,0
0,2,0,1092,4,0.0,1092,218.4,0
1,2,68,16,31,4.0,84,2.625,1
0,2,45,2068,72,0.021749637506041565,2113,28.945205479452056,0
2,0,1729,1418,3,1.2184637068358,3147,786.75,0
0,1,1812,256,26,7.0505836575875485,2068,76.5925925925926,0
2,0,1297,643,2,2.0139751552795033,1940,646.6666666666666,0
1,3,435,763,50,0.569371727748691,1198,23.49019607843137,0
0,3,1721,113,72,15.096491228070175,1834,25.123287671232877,0
1,3,776,234,29,3.302127659574468,1010,33.666666666666664,0
2,3,362,18,34,19.05263157894737,380,10.857142857142858,0
2,2,574,1595,1,0.35964912280701755,2169,1084.5,0
1,1,68,20,2,3.238095238095238,88,29.333333333333332,1
0,2,2898,306,5,9.439739413680782,3204,534.0,0
0,1,965,65,9,14.621212121212121,1030,103.0,1
2,1,1313,1216,42,1.0788824979457683,2529,58.81395348837209,0
1,0,1128,2072,17,0.5441389290882779,3200,177.77777777777777,0
1,3,1101,661,2,1.663141993957704,1762,587.3333333333334,0
0,1,17,120,57,0.14049586776859505,137,2.3620689655172415,0
0,3,745,653,152,1.1391437308868502,1398,9.137254901960784,0
0,3,1724,1176,18,1.4647408666100254,2900,152.6315789473684,0
1,3,45,1013,21,0.04437869822485207,1058,48.09090909090909,0
0,2,3127,1082,2,2.8873499538319485,4209,1403.0,0
0,3,551,261,14,2.1030534351145036,812,54.13333333333333,0
2,1,342,61,13,5.516129032258065,403,28.785714285714285,0
0,2,758,129,101,5.8307692307692305,887,8.696078431372548,0
0,3,1615,2489,32,0.6485943775100401,4104,124.36363636363636,0
1,0,643,760,45,0.8449408672798949,1403,30.5,0
1,3,1035,1041,4,0.9932821497120922,2076,415.2,0
2,3,692,1834,16,0.3771117166212534,2526,148.58823529411765,0
0,2,997,1532,6,0.6503587736464449,2529,361.2857142857143,0
2,1,148,197,59,0.7474747474747475,345,5.75,0
1,3,39,47,4,0.8125,86,17.2,0
2,2,147,2073,17,0.07087753134040502,2220,123.33333333333333,0
1,2,336,3199,1,0.105,3535,1767.5,0
2,1,292,670,30,0.43517138599105815,962,31.032258064516128,0
2,2,954,1754,19,0.5435897435897435,2708,135.4,0
0,1,608,210,20,2.881516587677725,818,38.95238095238095,0
2,0,39,94,3,0.4105263157894737,133,33.25,0
0,3,35,554,21,0.06306306306306306,589,26.772727272727273,0
0,2,94,1333,24,0.0704647676161919,1427,57.08,0
0,0,435,850,98,0.5111633372502937,1285,12.97979797979798,0
0,2,6,811,1,0.007389162561576354,817,408.5,0
2,2,681,14,76,45.4,695,9.025974025974026,0
1,0,447,305,19,1.4607843137254901,752,37.6,0
1,2,810,2244,7,0.36080178173719374,3054,381.75,0
1,2,1275,115,32,10.991379310344827,1390,42.121212121212125,0
2,0,288,1036,21,0.2777242044358727,1324,60.18181818181818,0
0,2,170,1139,7,0.14912280701754385,1309,163.625,0
1,1,325,1055,29,0.3077651515151515,1380,46.0,0
2,2,1,3628,19,0.0002755580049600441,3629,181.45,0
0,3,127,421,35,0.3009478672985782,548,15.222222222222221,0
1,2,1389,917,35,1.5130718954248366,2306,64.05555555555556,0
0,3,252,172,19,1.4566473988439306,424,21.2,0
1,3,5167,408,14,12.63325183374083,5575,371.6666666666667,1
1,2,183,541,1,0.3376383763837638,724,362.0,0
1,0,1554,193,20,8.010309278350515,1747,83.19047619047619,1
0,1,1220,1898,8,0.6424433912585571,3118,346.44444444444446,0
2,1,388,1007,1,0.38492063492063494,1395,697.5,0
0,2,401,266,12,1.5018726591760299,667,51.30769230769231,0
1,0,829,115,2,7.146551724137931,944,314.6666666666667,1
0,0,1913,271,26,7.033088235294118,2184,80.88888888888889,0
2,1,488,780,21,0.6248399487836107,1268,57.63636363636363,0
0,0,63,1400,47,0.044967880085653104,1463,30.479166666666668,0
2,2,469,559,9,0.8375,1028,102.8,0
2,2,232,86,13,2.6666666666666665,318,22.714285714285715,0
0,0,2800,229,35,12.173913043478262,3029,84.13888888888889,0
1,2,1194,338,148,3.52212389380531,1532,10.281879194630873,0
2,3,52,808,70,0.06427688504326329,860,12.112676056338028,0
0,1,346,226,22,1.524229074889868,572,24.869565217391305,0
2,2,51,213,33,0.2383177570093458,264,7.764705882352941,0
1,0,1772,269,22,6.562962962962963,2041,88.73913043478261,1
0,1,2367,718,17,3.2920723226703754,3085,171.38888888888889,0
0,2,119,542,27,0.21915285451197053,661,23.607142857142858,0
0,1,580,1474,14,0.39322033898305087,2054,136.93333333333334,0
1,0,2686,957,9,2.8037578288100207,3643,364.3,0
2,3,156,879,36,0.17727272727272728,1035,27.972972972972972,0
0,3,345,134,61,2.5555555555555554,479,7.725806451612903,0
2,2,362,45,10,7.869565217391305,407,37.0,1
2,3,30,570,36,0.05253940455341506,600,16.216216216216218,0
1,2,36,59,17,0.6,95,5.277777777777778,0
0,1,3053,362,10,8.410468319559229,3415,310.45454545454544,0
2,2,846,21,29,38.45454545454545,867,28.9,0
0,2,366,155,84,2.3461538461538463,521,6.129411764705883,0
0,2,475,93,13,5.053191489361702,568,40.57142857142857,0
1,3,1254,1291,42,0.9705882352941176,2545,59.18604651162791,0
0,2,456,339,11,1.3411764705882352,795,66.25,0
0,0,258,65,48,3.909090909090909,323,6.591836734693878,0
2,2,107,246,42,0.4331983805668016,353,8.209302325581396,0
1,1,1305,918,43,1.4200217627856366,2223,50.52272727272727,0
0,0,199,1095,182,0.18156934306569342,1294,7.0710382513661205,0
2,1,72,102,4,0.6990291262135923,174,34.8,0
1,1,556,1206,14,0.46064623032311514,1762,117.46666666666667,0
1,1,40,370,29,0.1078167115902965,410,13.666666666666666,0
2,0,3352,910,26,3.6794731064763995,4262,157.85185185185185,0
2,0,986,890,45,1.10662177328844,1876,40.78260869565217,0
2,3,165,1262,1,0.13064133016627077,1427,713.5,0
2,0,189,955,36,0.19769874476987448,1144,30.91891891891892,0
2,2,843,31,40,26.34375,874,21.317073170731707,0
0,1,440,586,1,0.7495741056218058,1026,513.0,0
0,3,1488,145,23,10.191780821917808,1633,68.04166666666667,1
1,0,789,2804,8,0.2812834224598931,3593,399.22222222222223,0
0,1,567,236,48,2.392405063291139,803,16.387755102040817,0
0,0,3296,435,1,7.559633027522936,3731,1865.5,0
0,3,495,175,4,2.8125,670,134.0,0
2,0,511,115,3,4.405172413793103,626,156.5,1
1,0,1095,734,2,1.489795918367347,1829,609.6666666666666,0
1,1,1657,543,27,3.045955882352941,2200,78.57142857142857,1
1,2,984,375,60,2.617021276595745,1359,22.278688524590162,0
1,0,1199,71,21,16.65277777777778,1270,57.72727272727273,0
0,3,466,1065,7,0.4371482176360225,1531,191.375,0
0,0,652,4,12,130.4,656,50.46153846153846,0
2,0,219,489,13,0.44693877551020406,708,50.57142857142857,0
1,2,1140,800,18,1.4232209737827715,1940,102.10526315789474,0
0,1,250,450,16,0.5543237250554324,700,41.1764705882353,0
0,3,1,107,33,0.009259259259259259,108,3.176470588235294,0
2,1,2714,1204,12,2.2522821576763485,3918,301.38461538461536,0
2,1,365,313,32,1.1624203821656052,678,20.545454545454547,0
2,1,218,115,23,1.8793103448275863,333,13.875,0
0,0,312,639,1,0.4875,951,475.5,0
0,2,401,15,75,25.0625,416,5.473684210526316,1
2,0,643,313,5,2.0477707006369426,956,159.33333333333334,0
1,3,71,1111,18,0.06384892086330936,1182,62.21052631578947,0
2,2,54,1950,88,0.027678113787801127,2004,22.51685393258427,0
2,1,346,716,8,0.4825662482566248,1062,118.0,0
2,2,350,196,0,1.7766497461928934,546,546.0,0
2,3,125,198,20,0.628140703517588,323,15.380952380952381,0
0,0,518,740,7,0.699055330634278,1258,157.25,0
1,0,334,417,26,0.7990430622009569,751,27.814814814814813,0
2,1,26,156,50,0.16560509554140126,182,3.5686274509803924,0
1,0,2169,1238,21,1.7506053268765134,3407,154.86363636363637,0
1,0,2171,178,31,12.128491620111731,2349,73.40625,0
1,3,234,310,32,0.752411575562701,544,16.484848484848484,0
2,2,177,50,51,3.4705882352941178,227,4.365384615384615,1
0,0,792,966,34,0.8190279214064116,1758,50.22857142857143,0
2,3,996,257,112,3.86046511627907,1253,11.08849557522124,0
1,3,3159,212,18,14.830985915492958,3371,177.42105263157896,1
1,1,473,289,1,1.6310344827586207,762,381.0,0
0,3,962,1658,15,0.5798673899939722,2620,163.75,0
2,1,2105,583,54,3.6044520547945207,2688,48.872727272727275,0
1,0,597,137,4,4.326086956521739,734,146.8,1
0,1,130,1191,39,0.10906040268456375,1321,33.025,0
1,3,473,187,23,2.515957446808511,660,27.5,0
0,2,146,425,69,0.3427230046948357,571,8.157142857142857,0
0,2,16,671,39,0.023809523809523808,687,17.175,0
2,0,1392,702,32,1.9800853485064012,2094,63.45454545454545,0
1,0,272,57,65,4.689655172413793,329,4.984848484848484,0
2,2,2,1450,71,0.0013783597518952446,1452,20.166666666666668,0
1,1,2059,522,14,3.936902485659656,2581,172.06666666666666,1
2,0,586,3627,78,0.1615214994487321,4213,53.32911392405063,0
1,3,272,1011,1,0.26877470355731226,1283,641.5,0
2,0,304,3921,43,0.07751147373788883,4225,96.02272727272727,0
0,1,275,483,12,0.5681818181818182,758,58.30769230769231,0
1,0,216,121,20,1.7704918032786885,337,16.047619047619047,0
1,3,1840,1039,54,1.7692307692307692,2879,52.345454545454544,0
0,3,186,1203,30,0.15448504983388706,1389,44.806451612903224,0
2,3,825,1532,18,0.538160469667319,2357,124.05263157894737,0
1,1,80,286,5,0.2787456445993031,366,61.0,0
1,1,2986,571,84,5.22027972027972,3557,41.84705882352941,0
2,3,924,1558,12,0.5926876202694035,2482,190.92307692307693,0
0,3,2334,1600,3,1.457838850718301,3934,983.5,0
2,1,507,20,24,24.142857142857142,527,21.08,0
2,1,1664,889,15,1.8696629213483147,2553,159.5625,0
2,1,1921,736,26,2.6065128900949794,2657,98.4074074074074,0
1,2,1213,69,7,17.32857142857143,1282,160.25,0
0,1,97,2128,14,0.045561296383278535,2225,148.33333333333334,0
0,3,16,471,107,0.03389830508474576,487,4.5092592592592595,0
2,2,184,897,82,0.20489977728285078,1081,13.024096385542169,0
1,1,125,1715,59,0.07284382284382285,1840,30.666666666666668,0
2,3,1291,111,45,11.526785714285714,1402,30.47826086956522,0
1,0,814,1549,5,0.5251612903225806,2363,393.8333333333333,0
1,2,746,1030,18,0.7235693501454898,1776,93.47368421052632,0
1,3,291,1464,39,0.19863481228668942,1755,43.875,0
1,0,167,546,9,0.3053016453382084,713,71.3,0
0,3,231,27,1,8.25,258,129.0,0
1,1,511,888,16,0.5748031496062992,1399,82.29411764705883,0
1,1,1347,375,16,3.5824468085106385,1722,101.29411764705883,0
2,0,293,411,2,0.7111650485436893,704,234.66666666666666,0
2,1,1199,465,11,2.572961373390558,1664,138.66666666666666,0
0,3,676,543,74,1.2426470588235294,1219,16.253333333333334,0
2,0,2166,867,8,2.4953917050691246,3033,337.0,0
1,3,265,1037,25,0.25529865125240847,1302,50.07692307692308,0
2,3,599,1199,20,0.49916666666666665,1798,85.61904761904762,0
0,3,101,890,59,0.11335578002244669,991,16.516666666666666,0
2,1,408,1301,31,0.31336405529953915,1709,53.40625,0
2,1,707,104,5,6.733333333333333,811,135.16666666666666,0
0,3,1319,1450,4,0.9090282563749138,2769,553.8,0
0,2,220,391,24,0.5612244897959183,611,24.44,0
1,3,246,601,1,0.40863787375415284,847,423.5,0
2,3,998,455,15,2.18859649122807,1453,90.8125,0
1,0,482,516,15,0.9323017408123792,998,62.375,0
2,3,657,268,6,2.442379182156134,925,132.14285714285714,0
2,1,1808,149,10,12.053333333333333,1957,177.9090909090909,0
1,0,691,88,12,7.764044943820225,779,59.92307692307692,0
2,2,1056,480,0,2.1954261954261955,1536,1536.0,0
2,0,1069,107,49,9.898148148148149,1176,23.52,1
2,2,1627,224,94,7.231111111111111,1851,19.48421052631579,0
0,0,1016,114,10,8.834782608695653,1130,102.72727272727273,0
1,0,67,92,3,0.7204301075268817,159,39.75,0
0,2,418,1712,92,0.24401634559252772,2130,22.903225806451612,0
1,1,4539,896,40,5.0602006688963215,5435,132.5609756097561,1
1,1,218,2059,66,0.10582524271844661,2277,33.985074626865675,0
2,1,883,826,13,1.067714631197098,1709,122.07142857142857,0
1,0,1851,1486,19,1.2447881640887692,3337,166.85,0
0,3,883,648,79,1.3605546995377504,1531,19.1375,0
0,0,465,496,18,0.9356136820925554,961,50.578947368421055,0
0,3,83,601,33,0.1378737541528239,684,20.11764705882353,0
1,3,448,308,36,1.4498381877022655,756,20.43243243243243,0
0,1,200,858,54,0.23282887077997672,1058,19.236363636363638,0
1,3,3240,1819,110,1.7802197802197801,5059,45.57657657657658,1
0,0,1255,1219,12,1.028688524590164,2474,190.30769230769232,0
0,0,1383,495,8,2.788306451612903,1878,208.66666666666666,0
1,1,572,2461,2,0.2323314378554021,3033,1011.0,0
0,2,116,3382,58,0.034289092521430684,3498,59.28813559322034,0
2,0,310,543,10,0.5698529411764706,853,77.54545454545455,0
1,3,300,1599,1,0.1875,1899,949.5,0
1,0,667,3,60,166.75,670,10.98360655737705,1
1,0,618,55,21,11.035714285714286,673,30.59090909090909,0
2,0,568,18,54,29.894736842105264,586,10.654545454545454,1
1,2,685,1186,24,0.5770850884582982,1871,74.84,0
0,3,4344,66,11,64.83582089552239,4410,367.5,0
0,1,354,13,4,25.285714285714285,367,73.4,0
0,0,955,127,17,7.4609375,1082,60.111111111111114,0
1,3,273,292,0,0.931740614334471,565,565.0,0
0,3,628,499,27,1.256,1127,40.25,0
1,1,223,54,16,4.054545454545455,277,16.294117647058822,0
0,0,816,552,4,1.4755877034358047,1368,273.6,0
2,2,307,228,22,1.3406113537117903,535,23.26086956521739,0
2,3,37,256,48,0.14396887159533073,293,5.979591836734694,0
2,1,1688,1380,110,1.222302679217958,3068,27.63963963963964,0
2,2,137,3469,22,0.039481268011527376,3606,156.7826086956522,0
1,3,458,498,4,0.9178356713426854,956,191.2,0
0,0,648,310,49,2.0836012861736335,958,19.16,0
2,3,566,2144,35,0.26386946386946386,2710,75.27777777777777,0
1,2,1293,555,92,2.3255395683453237,1848,19.870967741935484,0
2,2,908,1048,22,0.86558627264061,1956,85.04347826086956,0
2,0,350,427,13,0.8177570093457944,777,55.5,0
1,0,53,181,98,0.29120879120879123,234,2.3636363636363638,0
1,1,1459,851,23,1.7124413145539905,2310,96.25,0
0,0,434,874,0,0.496,1308,1308.0,0
0,1,2204,493,19,4.461538461538462,2697,134.85,0
2,2,502,251,0,1.992063492063492,753,753.0,0
2,2,1264,1426,40,0.8857743517869656,2690,65.60975609756098,0
0,3,2806,257,25,10.875968992248062,3063,117.8076923076923,0
0,3,1053,860,3,1.2229965156794425,1913,478.25,0
1,1,533,387,50,1.3737113402061856,920,18.03921568627451,0
0,0,837,511,23,1.634765625,1348,56.166666666666664,0
0,0,784,189,3,4.126315789473685,973,243.25,0
2,3,879,838,5,1.0476758045292014,1717,286.1666666666667,0
0,2,158,204,51,0.7707317073170732,362,6.961538461538462,0
2,1,1199,531,13,2.2537593984962405,1730,123.57142857142857,0
0,2,156,318,51,0.4890282131661442,474,9.115384615384615,0
1,2,14,2650,2,0.005281026027913994,2664,888.0,0
0,0,980,3223,8,0.303970223325062,4203,467.0,0
0,1,124,1120,43,0.11061552185548618,1244,28.272727272727273,0
0,2,1471,3304,30,0.4450832072617247,4775,154.03225806451613,0
2,3,2009,96,10,20.711340206185568,2105,191.36363636363637,0
1,3,2895,3895,82,0.7430698151950719,6790,81.80722891566265,1
0,0,1092,87,7,12.409090909090908,1179,147.375,1
2,3,657,429,56,1.527906976744186,1086,19.05263157894737,0
1,3,434,218,35,1.9817351598173516,652,18.11111111111111,0
2,2,675,2460,3,0.2742787484762292,3135,783.75,0
2,3,211,808,24,0.26081582200247216,1019,40.76,0
1,3,428,727,79,0.5879120879120879,1155,14.4375,0
0,2,1265,4773,28,0.26497695852534564,6038,208.20689655172413,1
2,0,245,758,22,0.3227931488801054,1003,43.608695652173914,0
2,0,306,831,13,0.36778846153846156,1137,81.21428571428571,0
0,1,1383,36,46,37.37837837837838,1419,30.19148936170213,0
0,3,195,1567,73,0.12436224489795919,1762,23.81081081081081,0
1,2,282,2807,41,0.10042735042735043,3089,73.54761904761905,0
1,1,17,2581,38,0.006584043377226956,2598,66.61538461538461,0
1,0,1273,199,6,6.365,1472,210.28571428571428,0
0,0,962,204,53,4.692682926829268,1166,21.59259259259259,0
2,2,1185,364,1,3.2465753424657535,1549,774.5,0
2,1,241,297,42,0.8087248322147651,538,12.511627906976743,0
1,1,1162,291,7,3.9794520547945207,1453,181.625,0
0,2,907,743,20,1.2190860215053763,1650,78.57142857142857,0
2,2,455,1310,35,0.34706331045003813,1765,49.02777777777778,0
1,1,575,2208,42,0.2602987777274785,2783,64.72093023255815,0
2,0,839,56,65,14.719298245614034,895,13.56060606060606,1
2,3,679,260,9,2.6015325670498086,939,93.9,0
0,0,1026,235,7,4.3474576271186445,1261,157.625,0
0,2,199,353,167,0.5621468926553672,552,3.2857142857142856,0
2,1,778,441,6,1.760180995475113,1219,174.14285714285714,0
1,1,598,394,32,1.5139240506329115,992,30.060606060606062,0
0,3,618,2431,91,0.25411184210526316,3049,33.141304347826086,0
2,1,633,459,68,1.376086956521739,1092,15.826086956521738,0
0,3,2132,641,17,3.3208722741433023,2773,154.05555555555554,0
0,0,1707,1104,30,1.5447963800904978,2811,90.6774193548387,0
0,0,993,1033,22,0.960348162475822,2026,88.08695652173913,0
2,1,1260,699,12,1.8,1959,150.69230769230768,0
1,1,43,1577,4,0.027249683143219267,1620,324.0,0
1,2,1362,782,48,1.739463601532567,2144,43.755102040816325,0
1,2,665,1662,2,0.39987973541791944,2327,775.6666666666666,0
0,1,382,288,28,1.3217993079584776,670,23.103448275862068,0
2,1,150,113,27,1.3157894736842106,263,9.392857142857142,0
0,0,78,1369,12,0.05693430656934306,1447,111.3076923076923,0
1,1,45,385,4,0.11658031088082901,430,86.0,0
1,2,176,842,48,0.20877817319098457,1018,20.775510204081634,0
2,0,30,1069,18,0.028037383177570093,1099,57.8421052631579,0
0,3,1319,316,38,4.160883280757098,1635,41.92307692307692,0
1,2,285,562,0,0.5062166962699822,847,847.0,0
2,2,460,1802,2,0.25513033832501386,2262,754.0,0
0,0,1730,1694,5,1.0206489675516224,3424,570.6666666666666,0
0,3,121,1106,3,0.1093044263775971,1227,306.75,0
1,2,1805,1150,6,1.5682015638575153,2955,422.14285714285717,0
1,1,1020,1823,34,0.5592105263157895,2843,81.22857142857143,0
0,2,418,1066,1,0.3917525773195876,1484,742.0,0
0,0,125,331,1,0.37650602409638556,456,228.0,0
1,0,95,102,0,0.9223300970873787,197,197.0,0
0,0,408,438,35,0.929384965831435,846,23.5,0
1,2,151,73,23,2.0405405405405403,224,9.333333333333334,0
0,3,311,98,13,3.1414141414141414,409,29.214285714285715,1
1,1,54,2399,33,0.0225,2453,72.1470588235294,0
2,0,903,901,24,1.001108647450111,1804,72.16,0
1,3,156,1526,0,0.10216110019646366,1682,1682.0,0
1,1,1413,823,54,1.7148058252427185,2236,40.654545454545456,0
2,0,246,433,12,0.5668202764976958,679,52.23076923076923,0
0,1,1599,20,15,76.14285714285714,1619,101.1875,0
2,1,210,2495,45,0.08413461538461539,2705,58.80434782608695,0
1,3,1277,58,6,21.64406779661017,1335,190.71428571428572,1
0,1,405,753,0,0.5371352785145889,1158,1158.0,0
2,0,874,86,71,10.045977011494253,960,13.333333333333334,1
0,3,39,267,21,0.1455223880597015,306,13.909090909090908,0
0,2,683,164,12,4.13939393939394,847,65.15384615384616,0
2,2,160,645,51,0.2476780185758514,805,15.48076923076923,0
0,3,666,1744,0,0.3816618911174785,2410,2410.0,0
2,2,152,807,6,0.18811881188118812,959,137.0,0
1,1,574,872,5,0.6575028636884307,1446,241.0,0
0,0,117,1916,40,0.06103286384976526,2033,49.58536585365854,0
1,1,248,1107,11,0.22382671480144403,1355,112.91666666666667,0
1,3,904,1607,44,0.5621890547263682,2511,55.8,0
0,0,3757,430,1,8.7169373549884,4187,2093.5,1
2,3,596,1604,28,0.3713395638629283,2200,75.86206896551724,0
0,3,1162,830,11,1.398315282791817,1992,166.0,0
1,3,775,116,6,6.6239316239316235,891,127.28571428571429,0
1,1,689,31,50,21.53125,720,14.117647058823529,0
2,0,66,223,15,0.29464285714285715,289,18.0625,0
0,0,155,380,25,0.4068241469816273,535,20.576923076923077,0
1,0,2146,1453,1,1.4759284731774416,3599,1799.5,0
1,1,527,1081,47,0.48706099815157117,1608,33.5,0
1,2,952,2487,10,0.38263665594855306,3439,312.6363636363636,0
2,1,751,655,35,1.1448170731707317,1406,39.05555555555556,0
1,1,476,1101,42,0.4319419237749546,1577,36.674418604651166,0
1,3,490,257,3,1.8992248062015504,747,186.75,0
0,0,810,910,10,0.889132821075741,1720,156.36363636363637,0
0,0,152,979,38,0.15510204081632653,1131,29.0,0
1,2,489,1509,7,0.32384105960264903,1998,249.75,0
1,2,592,614,56,0.9626016260162602,1206,21.157894736842106,0
0,3,4208,837,11,5.021479713603819,5045,420.4166666666667,1
2,0,433,181,15,2.379120879120879,614,38.375,0
2,2,1034,1067,3,0.9681647940074907,2101,525.25,0
2,2,147,1458,4,0.10075394105551748,1605,321.0,0
2,0,67,720,9,0.09292649098474341,787,78.7,0
2,1,2052,98,1,20.727272727272727,2150,1075.0,0
2,2,1312,300,6,4.358803986710964,1612,230.28571428571428,1
2,0,381,516,15,0.7369439071566731,897,56.0625,0
2,2,702,904,14,0.7756906077348066,1606,107.06666666666666,0
0,3,145,308,6,0.4692556634304207,453,64.71428571428571,0
2,2,1228,1467,2,0.8365122615803815,2695,898.3333333333334,0
2,0,72,371,11,0.1935483870967742,443,36.916666666666664,0
2,2,1414,35,41,39.27777777777778,1449,34.5,0
1,3,791,1263,21,0.6257911392405063,2054,93.36363636363636,0
0,3,326,826,88,0.3941958887545345,1152,12.9438202247191,0
0,2,1984,1295,4,1.5308641975308641,3279,655.8,0
0,2,4273,343,6,12.421511627906977,4616,659.4285714285714,0
2,3,293,14,9,19.533333333333335,307,30.7,0
2,3,1641,61,0,26.467741935483872,1702,1702.0,0
1,1,1386,94,86,14.589473684210526,1480,17.011494252873565,1
0,1,1375,1308,17,1.050420168067227,2683,149.05555555555554,0
2,3,3152,286,19,10.982578397212544,3438,171.9,0
0,2,666,4932,5,0.13500912223798905,5598,933.0,1
1,0,1121,1136,61,0.9859278803869833,2257,36.403225806451616,0
1,2,1736,735,35,2.358695652173913,2471,68.63888888888889,0
1,2,653,3289,16,0.19848024316109422,3942,231.88235294117646,0
0,1,656,304,63,2.1508196721311474,960,15.0,0
2,1,383,144,70,2.6413793103448278,527,7.422535211267606,0
2,1,1517,1069,1,1.4177570093457943,2586,1293.0,0
1,3,1158,260,3,4.436781609195402,1418,354.5,0
2,3,599,2596,0,0.23065075086638429,3195,3195.0,0
1,2,543,3542,26,0.15325994919559696,4085,151.2962962962963,0
0,2,75,2087,7,0.035919540229885055,2162,270.25,0
1,0,6,2316,55,0.002589555459646094,2322,41.464285714285715,0
0,2,752,764,18,0.9830065359477124,1516,79.78947368421052,0
1,2,540,942,54,0.5726405090137858,1482,26.945454545454545,0
2,1,1589,79,24,19.8625,1668,66.72,0
2,1,782,1151,47,0.6788194444444444,1933,40.270833333333336,0
1,1,2759,180,13,15.243093922651934,2939,209.92857142857142,1
2,1,218,1467,87,0.14850136239782016,1685,19.147727272727273,0
2,1,4620,2606,33,1.7721518987341771,7226,212.52941176470588,1
2,0,353,190,27,1.8481675392670156,543,19.392857142857142,0
0,0,1028,64,13,15.815384615384616,1092,78.0,0
2,0,696,529,83,1.3132075471698113,1225,14.583333333333334,0
0,1,445,1254,12,0.3545816733067729,1699,130.69230769230768,0
1,3,150,1177,54,0.1273344651952462,1327,24.12727272727273,0
2,1,144,954,15,0.15078534031413612,1098,68.625,0
2,1,1243,1374,43,0.904,2617,59.47727272727273,0
2,0,474,153,72,3.0779220779220777,627,8.58904109589041,1
1,1,3251,844,18,3.847337278106509,4095,215.52631578947367,1
0,0,394,744,22,0.5288590604026846,1138,49.47826086956522,0
0,1,4105,133,12,30.634328358208954,4238,326.0,1
2,2,229,428,1,0.5337995337995338,657,328.5,0
1,3,108,1531,31,0.07049608355091384,1639,51.21875,0
1,3,374,2854,3,0.13099824868651488,3228,807.0,0
1,0,2167,875,13,2.473744292237443,3042,217.28571428571428,0
1,2,737,2040,12,0.36109750122488976,2777,213.6153846153846,0
1,3,145,113,4,1.2719298245614035,258,51.6,0
0,0,226,2953,32,0.07650643195666892,3179,96.33333333333333,0
0,1,372,27,5,13.285714285714286,399,66.5,1
0,1,892,599,45,1.4866666666666666,1491,32.41304347826087,0
2,2,404,275,8,1.463768115942029,679,75.44444444444444,0
1,3,1374,1345,10,1.0208023774145616,2719,247.1818181818182,0
2,1,957,196,12,4.8578680203045685,1153,88.6923076923077,1
1,0,2070,9,4,207.0,2079,415.8,0
0,1,695,428,17,1.6200466200466201,1123,62.388888888888886,0
2,1,402,53,2,7.444444444444445,455,151.66666666666666,0
0,3,5591,274,16,20.330909090909092,5865,345.0,1
1,3,439,825,12,0.5314769975786925,1264,97.23076923076923,0
1,0,559,279,12,1.9964285714285714,838,64.46153846153847,0
1,2,1656,225,32,7.327433628318584,1881,57.0,0
0,2,92,135,43,0.6764705882352942,227,5.159090909090909,0
1,1,488,116,13,4.170940170940171,604,43.142857142857146,0
0,0,89,596,9,0.1490787269681742,685,68.5,0
2,2,150,915,20,0.16375545851528384,1065,50.714285714285715,0
1,2,4,482,46,0.008281573498964804,486,10.340425531914894,0
1,1,9,105,31,0.08490566037735849,114,3.5625,0
1,0,478,834,1,0.5724550898203593,1312,656.0,0
2,2,1656,651,19,2.539877300613497,2307,115.35,0
1,3,884,384,141,2.296103896103896,1268,8.929577464788732,0
0,3,1007,320,13,3.1370716510903427,1327,94.78571428571429,1
0,1,732,161,17,4.518518518518518,893,49.611111111111114,1
1,1,1713,126,10,13.488188976377952,1839,167.1818181818182,0
1,1,2123,330,20,6.413897280966768,2453,116.80952380952381,0
2,1,1895,34,5,54.142857142857146,1929,321.5,0
2,2,1672,459,8,3.634782608695652,2131,236.77777777777777,0
2,0,201,736,37,0.2727272727272727,937,24.657894736842106,0
1,1,901,2273,4,0.39621811785400174,3174,634.8,0
2,1,872,786,78,1.108005082592122,1658,20.9873417721519,0
2,2,750,782,11,0.9578544061302682,1532,127.66666666666667,0
0,1,655,375,25,1.7420212765957446,1030,39.61538461538461,0
2,1,93,114,11,0.808695652173913,207,17.25,0
0,0,107,473,19,0.22573839662447256,580,29.0,0
0,3,2325,730,70,3.180574555403557,3055,43.028169014084504,0
2,1,994,1029,2,0.9650485436893204,2023,674.3333333333334,0
0,2,304,1399,58,0.21714285714285714,1703,28.864406779661017,0
1,0,327,236,24,1.379746835443038,563,22.52,0
1,2,942,220,32,4.262443438914027,1162,35.21212121212121,0
2,0,522,666,1,0.782608695652174,1188,594.0,0
1,0,582,667,42,0.8712574850299402,1249,29.046511627906977,0
0,1,62,196,4,0.3147208121827411,258,51.6,0
1,1,149,708,100,0.21015514809590974,857,8.485148514851485,0
2,1,499,339,48,1.4676470588235293,838,17.102040816326532,0
2,3,1202,815,20,1.4730392156862746,2017,96.04761904761905,0
0,3,49,275,77,0.17753623188405798,324,4.153846153846154,0
2,2,407,717,5,0.5668523676880223,1124,187.33333333333334,0
1,1,1187,1169,143,1.0145299145299145,2356,16.36111111111111,0
2,3,1570,3135,37,0.5006377551020408,4705,123.8157894736842,0
0,1,210,1935,3,0.10847107438016529,2145,536.25,0
2,3,1314,560,23,2.342245989304813,1874,78.08333333333333,0
1,3,3110,536,37,5.791433891992551,3646,95.94736842105263,0
0,0,2373,460,28,5.1475054229934925,2833,97.6896551724138,0
1,1,1557,22,16,67.69565217391305,1579,92.88235294117646,1
0,1,1245,145,8,8.527397260273972,1390,154.44444444444446,1
2,3,268,48,8,5.469387755102041,316,35.111111111111114,0
0,1,1004,953,78,1.0524109014675052,1957,24.772151898734176,0
0,3,1030,426,8,2.4121779859484778,1456,161.77777777777777,0
2,1,522,52,98,9.849056603773585,574,5.797979797979798,0
1,0,679,938,7,0.7231096911608094,1617,202.125,0
2,1,1184,827,14,1.429951690821256,2011,134.06666666666666,0
0,0,3038,1018,0,2.9813542688910695,4056,4056.0,0
2,2,349,732,70,0.4761255115961801,1081,15.225352112676056,0
0,1,282,140,3,2.0,422,105.5,0
2,1,920,50,13,18.03921568627451,970,69.28571428571429,0
2,1,140,1359,55,0.10294117647058823,1499,26.767857142857142,0
1,0,873,194,47,4.476923076923077,1067,22.229166666666668,1
0,1,93,625,55,0.1485623003194888,718,12.821428571428571,0
1,1,674,531,73,1.2669172932330828,1205,16.283783783783782,0
0,3,968,2031,72,0.4763779527559055,2999,41.082191780821915,0
2,2,72,643,44,0.11180124223602485,715,15.88888888888889,0
0,0,231,694,26,0.33237410071942447,925,34.25925925925926,0
1,3,408,307,24,1.3246753246753247,715,28.6,0
1,0,459,2549,0,0.18,3008,3008.0,1
1,3,1127,758,38,1.4848484848484849,1885,48.333333333333336,0
0,2,752,3,7,188.0,755,94.375,0
1,3,481,649,52,0.74,1130,21.32075471698113,0
1,0,599,361,24,1.6546961325966851,960,38.4,0
1,1,13,26,130,0.48148148148148145,39,0.29770992366412213,0
2,1,1471,451,7,3.254424778761062,1922,240.25,0
2,2,41,1188,38,0.034482758620689655,1229,31.512820512820515,0
0,0,1767,560,23,3.1497326203208558,2327,96.95833333333333,0
0,0,778,816,80,0.9522643818849449,1594,19.679012345679013,0
1,0,750,816,9,0.9179926560587516,1566,156.6,0
2,2,1219,889,1,1.3696629213483147,2108,1054.0,0
1,1,1962,392,23,4.99236641221374,2354,98.08333333333333,0
1,3,2858,369,22,7.724324324324324,3227,140.30434782608697,1
2,2,783,3,11,195.75,786,65.5,0
2,3,163,133,129,1.2164179104477613,296,2.276923076923077,0
2,1,2108,2409,2,0.8746887966804979,4517,1505.6666666666667,0
0,2,41,1478,25,0.027721433400946585,1519,58.42307692307692,0
0,1,1646,257,9,6.37984496124031,1903,190.3,0
1,3,1140,410,0,2.7737226277372264,1550,1550.0,0
0,0,2351,2249,132,1.044888888888889,4600,34.58646616541353,1
2,0,2277,230,19,9.857142857142858,2507,125.35,1
2,3,54,608,58,0.08866995073891626,662,11.220338983050848,0
0,0,940,17,54,52.22222222222222,957,17.4,0
1,3,133,773,50,0.17183462532299743,906,17.764705882352942,0
1,2,81,2128,18,0.0380460310004697,2209,116.26315789473684,0
0,2,594,1728,67,0.3435511856564488,2322,34.14705882352941,0
1,2,102,557,13,0.1827956989247312,659,47.07142857142857,0
1,0,1301,839,15,1.5488095238095239,2140,133.75,0
1,1,3471,674,8,5.142222222222222,4145,460.55555555555554,0
2,0,843,55,17,15.053571428571429,898,49.888888888888886,1
2,0,268,138,129,1.9280575539568345,406,3.123076923076923,0
0,1,1852,2655,25,0.697289156626506,4507,173.34615384615384,1
2,1,1918,236,53,8.092827004219409,2154,39.888888888888886,1
1,1,1319,388,9,3.390745501285347,1707,170.7,0
2,1,954,568,93,1.6766256590509665,1522,16.19148936170213,0
0,0,2023,3095,0,0.6534237726098191,5118,5118.0,1
2,3,178,936,79,0.18996798292422626,1114,13.925,0
1,2,2682,794,68,3.3735849056603775,3476,50.3768115942029,0
1,3,2941,594,2,4.942857142857143,3535,1178.3333333333333,0
0,0,2055,964,27,2.1295336787564767,3019,107.82142857142857,0
2,1,288,872,46,0.32989690721649484,1160,24.680851063829788,0
2,2,1953,1865,15,1.0466237942122187,3818,238.625,0
2,2,688,624,2,1.1008,1312,437.3333333333333,0
1,3,903,437,53,2.0616438356164384,1340,24.814814814814813,0
0,0,1836,1316,18,1.3940774487471526,3152,165.89473684210526,0
2,0,30,1286,9,0.023310023310023312,1316,131.6,0
1,0,450,148,2,3.0201342281879193,598,199.33333333333334,1
1,2,1691,216,30,7.792626728110599,1907,61.516129032258064,0
1,3,1681,2548,1,0.6594743036484896,4229,2114.5,0
2,2,1888,469,46,4.017021276595744,2357,50.148936170212764,0
2,2,185,586,44,0.3151618398637138,771,17.133333333333333,0
2,1,1223,297,11,4.104026845637584,1520,126.66666666666667,1
2,3,158,524,19,0.30095238095238097,682,34.1,0
2,1,1537,1088,33,1.411386593204775,2625,77.20588235294117,0
2,0,281,526,95,0.5332068311195446,807,8.40625,0
2,2,1338,302,22,4.415841584158416,1640,71.30434782608695,1
2,3,606,80,171,7.481481481481482,686,3.988372093023256,0
2,0,4287,2107,11,2.0336812144212524,6394,532.8333333333334,0
1,3,867,1642,22,0.5276932440657334,2509,109.08695652173913,0
2,2,1001,1253,3,0.7982456140350878,2254,563.5,0
0,3,459,947,24,0.48417721518987344,1406,56.24,0
1,0,1326,579,23,2.286206896551724,1905,79.375,0
2,1,682,1821,56,0.3743139407244786,2503,43.91228070175438,0
0,2,18,1255,170,0.014331210191082803,1273,7.444444444444445,0
2,1,937,1354,128,0.6915129151291513,2291,17.75968992248062,0
0,2,1774,296,8,5.973063973063973,2070,230.0,1
0,0,270,440,12,0.6122448979591837,710,54.61538461538461,0
0,2,249,981,9,0.2535641547861507,1230,123.0,0
0,1,938,370,6,2.5283018867924527,1308,186.85714285714286,0
1,2,1703,544,4,3.1247706422018346,2247,449.4,1
1,0,287,831,21,0.3449519230769231,1118,50.81818181818182,0
0,2,2692,460,61,5.839479392624729,3152,50.83870967741935,0
2,1,2622,1260,26,2.0793021411578114,3882,143.77777777777777,0
0,0,223,98,61,2.2525252525252526,321,5.17741935483871,0
1,1,306,1012,96,0.3020730503455084,1318,13.587628865979381,0
2,2,1205,125,14,9.563492063492063,1330,88.66666666666667,0
1,3,3031,2222,54,1.3634727845254162,5253,95.50909090909092,0
1,1,1237,301,1,4.096026490066225,1538,769.0,0
2,2,588,1269,19,0.462992125984252,1857,92.85,0
0,3,185,589,13,0.3135593220338983,774,55.285714285714285,0
0,3,618,76,6,8.025974025974026,694,99.14285714285714,0
0,0,933,698,17,1.3347639484978542,1631,90.61111111111111,0
0,3,401,1945,17,0.20606372045220966,2346,130.33333333333334,0
2,1,713,136,49,5.204379562043796,849,16.98,0
2,1,139,310,60,0.44694533762057875,449,7.360655737704918,0
2,3,601,462,32,1.2980561555075594,1063,32.21212121212121,0
1,2,95,257,30,0.3682170542635659,352,11.35483870967742,0
2,1,50,2302,3,0.021710811984368215,2352,588.0,0
0,1,1946,379,25,5.121052631578947,2325,89.42307692307692,0
1,0,229,858,9,0.26658905704307334,1087,108.7,0
0,2,856,202,10,4.216748768472907,1058,96.18181818181819,1
0,3,161,198,2,0.8090452261306532,359,119.66666666666667,0
2,2,304,154,30,1.961290322580645,458,14.774193548387096,0
2,0,448,456,26,0.9803063457330415,904,33.48148148148148,0
0,0,155,608,7,0.2545155993431856,763,95.375,0
0,2,47,8,9,5.222222222222222,55,5.5,1
1,0,2096,1431,44,1.4636871508379887,3527,78.37777777777778,0
2,0,11,575,47,0.019097222222222224,586,12.208333333333334,0
1,0,63,136,20,0.45985401459854014,199,9.476190476190476,0
1,2,1635,55,4,29.196428571428573,1690,338.0,1
1,0,331,52,1,6.245283018867925,383,191.5,0
0,3,1283,238,9,5.368200836820083,1521,152.1,0
1,3,158,553,39,0.2851985559566787,711,17.775,0
1,1,270,1574,27,0.17142857142857143,1844,65.85714285714286,0
0,3,850,1866,37,0.45527584359935724,2716,71.47368421052632,0
2,1,4477,1428,19,3.13296011196641,5905,295.25,0
2,2,76,318,42,0.23824451410658307,394,9.162790697674419,0
1,0,511,292,19,1.7440273037542662,803,40.15,0
0,3,44,3502,2,0.012560662289466172,3546,1182.0,0
2,1,222,914,2,0.24262295081967214,1136,378.6666666666667,0
1,2,2380,291,53,8.150684931506849,2671,49.46296296296296,0
1,1,101,319,29,0.315625,420,14.0,0
0,0,1943,456,9,4.25164113785558,2399,239.9,0
1,3,195,777,42,0.2506426735218509,972,22.6046511627907,0
2,2,1978,1826,4,1.0826491516146688,3804,760.8,0
0,1,772,176,31,4.361581920903955,948,29.625,0
2,2,2105,70,136,29.64788732394366,2175,15.875912408759124,1
2,1,164,416,4,0.3932853717026379,580,116.0,0
2,1,1435,225,4,6.349557522123894,1660,332.0,1
1,0,1141,686,18,1.660844250363901,1827,96.15789473684211,0
1,0,782,961,30,0.8128898128898129,1743,56.225806451612904,0
2,1,1663,297,0,5.580536912751678,1960,1960.0,0
2,3,1044,925,20,1.1274298056155507,1969,93.76190476190476,0
0,2,2095,336,2,6.216617210682492,2431,810.3333333333334,1
0,2,479,806,8,0.5935563816604709,1285,142.77777777777777,0
1,0,891,802,37,1.1095890410958904,1693,44.55263157894737,0
1,3,2044,260,40,7.831417624521073,2304,56.19512195121951,0
0,1,241,807,39,0.29826732673267325,1048,26.2,0
2,0,665,383,2,1.7317708333333333,1048,349.3333333333333,0
1,1,3237,328,46,9.838905775075988,3565,75.85106382978724,1
2,1,641,273,16,2.3394160583941606,914,53.76470588235294,0
0,0,291,339,19,0.8558823529411764,630,31.5,0
1,3,432,1236,16,0.349232012934519,1668,98.11764705882354,0
1,2,2163,225,58,9.570796460176991,2388,40.47457627118644,0
0,0,3098,916,34,3.3784078516902945,4014,114.68571428571428,0
1,3,2997,1847,20,1.6217532467532467,4844,230.66666666666666,0
0,1,1200,345,53,3.468208092485549,1545,28.61111111111111,0
1,0,712,23,49,29.666666666666668,735,14.7,0
0,2,201,19,0,10.05,220,220.0,0
1,2,131,120,19,1.0826446280991735,251,12.55,0
2,1,61,93,1,0.648936170212766,154,77.0,0
2,0,17,1102,11,0.015412511332728921,1119,93.25,0
2,2,2104,279,48,7.514285714285714,2383,48.63265306122449,0
1,0,1655,845,86,1.9562647754137117,2500,28.735632183908045,0
1,2,838,34,8,23.942857142857143,872,96.88888888888889,0
2,1,6663,280,0,23.71174377224199,6943,6943.0,1
2,1,3058,213,15,14.289719626168225,3271,204.4375,0
0,0,1064,259,12,4.092307692307692,1323,101.76923076923077,0
0,3,624,169,33,3.6705882352941175,793,23.323529411764707,0
0,3,165,769,20,0.21428571428571427,934,44.476190476190474,0
2,1,724,869,15,0.832183908045977,1593,99.5625,0
2,2,171,128,7,1.3255813953488371,299,37.375,0
2,3,508,1081,52,0.46950092421441775,1589,29.9811320754717,0
0,1,2858,230,8,12.372294372294371,3088,343.1111111111111,0
1,2,418,266,1,1.5655430711610487,684,342.0,0
2,2,165,1411,24,0.11685552407932011,1576,63.04,0
1,3,873,1851,11,0.4713822894168467,2724,227.0,0
1,1,922,1393,37,0.6614060258249641,2315,60.921052631578945,0
1,2,215,127,2,1.6796875,342,114.0,0
0,2,218,5775,101,0.037742382271468145,5993,58.754901960784316,0
1,0,4561,892,6,5.107502799552072,5453,779.0,1
2,0,278,571,13,0.486013986013986,849,60.642857142857146,0
0,3,1821,2478,19,0.7345703912868092,4299,214.95,0
2,0,635,1360,66,0.4665686994856723,1995,29.776119402985074,0
2,1,570,941,38,0.6050955414012739,1511,38.743589743589745,0
0,3,349,1458,4,0.23920493488690883,1807,361.4,0
2,3,1486,389,17,3.81025641025641,1875,104.16666666666667,1
2,0,2125,922,23,2.302275189599133,3047,126.95833333333333,0
0,2,302,169,36,1.776470588235294,471,12.72972972972973,0
2,1,99,3538,25,0.02797400395591975,3637,139.8846153846154,0
1,1,147,711,18,0.20646067415730338,858,45.1578947368421,0
2,1,1574,1346,43,1.1685226429101707,2920,66.36363636363636,0
1,3,572,418,14,1.3651551312649164,990,66.0,0
2,1,141,1137,130,0.12390158172231985,1278,9.755725190839694,0
0,2,415,392,88,1.0559796437659033,807,9.067415730337078,0
0,2,722,713,36,1.011204481792717,1435,38.78378378378378,0
2,0,1910,1204,64,1.5850622406639003,3114,47.90769230769231,0
0,1,1026,99,14,10.26,1125,75.0,0
2,3,193,353,26,0.5451977401129944,546,20.22222222222222,0
0,0,172,629,9,0.273015873015873,801,80.1,0
1,2,531,325,65,1.6288343558282208,856,12.969696969696969,0
2,1,78,295,19,0.2635135135135135,373,18.65,0
1,2,1408,264,23,5.313207547169811,1672,69.66666666666667,0
1,0,513,206,59,2.4782608695652173,719,11.983333333333333,0
2,2,420,1511,47,0.2777777777777778,1931,40.229166666666664,0
1,1,711,2058,11,0.345313258863526,2769,230.75,0
2,1,1234,963,2,1.2800829875518671,2197,732.3333333333334,0
1,0,842,24,5,33.68,866,144.33333333333334,0
2,1,1621,1234,12,1.3125506072874493,2855,219.6153846153846,0
2,2,992,607,10,1.631578947368421,1599,145.36363636363637,0
0,2,1551,1135,1,1.3653169014084507,2686,1343.0,0
2,3,1193,460,16,2.5878524945770067,1653,97.23529411764706,0
2,3,214,33,3,6.294117647058823,247,61.75,0
1,3,53,915,7,0.05786026200873363,968,121.0,0
2,2,2337,469,46,4.972340425531915,2806,59.702127659574465,1
0,2,2912,1657,20,1.7563329312424607,4569,217.57142857142858,0
1,0,1298,1071,14,1.210820895522388,2369,157.93333333333334,0
1,3,1288,356,6,3.607843137254902,1644,234.85714285714286,1
0,2,314,1030,60,0.30455868089233756,1344,22.0327868852459,0
1,0,781,546,70,1.4277879341864717,1327,18.690140845070424,0
1,2,4858,177,21,27.292134831460675,5035,228.86363636363637,1
1,0,1938,435,76,4.444954128440367,2373,30.818181818181817,1
1,3,362,201,18,1.7920792079207921,563,29.63157894736842,0
0,3,358,3,3,89.5,361,90.25,0
0,3,660,226,0,2.907488986784141,886,886.0,0
1,2,518,188,4,2.740740740740741,706,141.2,0
1,2,463,3,29,115.75,466,15.533333333333333,0
0,0,986,1225,11,0.8042414355628059,2211,184.25,0
0,1,11,64,31,0.16923076923076924,75,2.34375,0
0,1,1441,476,21,3.0209643605870022,1917,87.13636363636364,0
1,3,1347,432,12,3.1108545034642034,1779,136.84615384615384,0
1,1,1773,160,7,11.012422360248447,1933,241.625,0
2,3,1841,2725,2,0.6753484959647835,4566,1522.0,0
0,0,835,740,45,1.1268556005398112,1575,34.23913043478261,0
1,1,1514,1343,51,1.1264880952380953,2857,54.94230769230769,0
0,1,678,548,23,1.2349726775956285,1226,51.083333333333336,0
1,3,3026,1026,5,2.946445959104187,4052,675.3333333333334,0
0,0,211,2799,9,0.07535714285714286,3010,301.0,0
1,1,2472,342,93,7.206997084548105,2814,29.93617021276596,0
2,1,299,561,7,0.5320284697508897,860,107.5,0
2,1,108,578,1,0.18652849740932642,686,343.0,0
0,0,578,3862,23,0.14962464405902148,4440,185.0,0
1,0,954,212,9,4.47887323943662,1166,116.6,0
1,1,262,899,94,0.2911111111111111,1161,12.221052631578948,0
0,3,811,119,25,6.758333333333334,930,35.76923076923077,0
1,3,1649,2094,101,0.7871121718377089,3743,36.69607843137255,0
0,1,297,714,46,0.4153846153846154,1011,21.51063829787234,0
1,0,868,1569,38,0.5528662420382165,2437,62.48717948717949,0
0,1,414,1804,53,0.2293628808864266,2218,41.074074074074076,0
1,0,754,651,27,1.156441717791411,1405,50.17857142857143,0
0,1,1099,916,0,1.1984732824427482,2015,2015.0,0
1,0,431,959,14,0.44895833333333335,1390,92.66666666666667,0
2,2,5199,493,7,10.524291497975709,5692,711.5,0
1,3,829,456,17,1.8140043763676148,1285,71.38888888888889,0
0,2,1739,164,19,10.539393939393939,1903,95.15,0
2,3,1291,387,4,3.327319587628866,1678,335.6,0
1,0,1915,3747,0,0.5109391675560299,5662,5662.0,1
2,2,190,251,4,0.753968253968254,441,88.2,0
1,3,251,1149,58,0.2182608695652174,1400,23.728813559322035,0
2,1,668,48,42,13.63265306122449,716,16.651162790697676,1
0,0,1912,504,48,3.786138613861386,2416,49.30612244897959,1
1,0,220,48,9,4.489795918367347,268,26.8,0
1,1,3542,516,8,6.851063829787234,4058,450.8888888888889,1
0,1,136,22,1,5.913043478260869,158,79.0,0
2,3,192,760,19,0.25229960578186594,952,47.6,0
0,0,183,706,14,0.25884016973125884,889,59.266666666666666,0
0,3,881,1278,54,0.6888193901485535,2159,39.25454545454546,0
2,1,2495,700,34,3.559201141226819,3195,91.28571428571429,0
0,0,294,2082,4,0.14114258281325012,2376,475.2,0
1,1,805,1222,130,0.6582174979558463,2027,15.473282442748092,0
1,3,193,113,44,1.6929824561403508,306,6.8,0
1,3,997,246,38,4.036437246963563,1243,31.871794871794872,0
0,3,131,21,7,5.954545454545454,152,19.0,0
1,0,675,390,70,1.7263427109974425,1065,15.0,0
1,1,1064,569,19,1.8666666666666667,1633,81.65,0
1,1,865,2334,10,0.37044967880085655,3199,290.8181818181818,0
1,3,150,590,31,0.25380710659898476,740,23.125,0
1,3,175,1215,7,0.14391447368421054,1390,173.75,0
1,3,1112,249,71,4.448,1361,18.90277777777778,1
0,3,1655,132,57,12.443609022556391,1787,30.810344827586206,0
1,2,2386,1332,18,1.789947486871718,3718,195.68421052631578,0
1,2,1679,227,6,7.364035087719298,1906,272.2857142857143,0
2,2,3646,1640,20,2.221815965874467,5286,251.71428571428572,0
0,3,524,148,4,3.5167785234899327,672,134.4,0
0,3,402,1526,9,0.2632612966601179,1928,192.8,0
0,1,28,1185,19,0.023608768971332208,1213,60.65,0
0,0,597,755,0,0.7896825396825397,1352,1352.0,0
1,1,1053,1518,43,0.6932192231731402,2571,58.43181818181818,0
1,2,1689,321,6,5.245341614906832,2010,287.14285714285717,0
2,1,311,145,60,2.1301369863013697,456,7.475409836065574,0
2,3,720,136,0,5.255474452554744,856,856.0,0
0,2,1084,252,22,4.284584980237154,1336,58.08695652173913,1
2,2,802,472,44,1.6955602536997887,1274,28.31111111111111,0
2,0,320,1670,8,0.19150209455415917,1990,221.11111111111111,0
0,0,1591,75,36,20.93421052631579,1666,45.027027027027025,0
0,2,190,1974,38,0.09620253164556962,2164,55.48717948717949,0
2,2,2353,2077,30,1.1323387872954764,4430,142.90322580645162,0
1,1,3049,1039,13,2.9317307692307693,4088,292.0,0
2,2,455,1844,46,0.24661246612466126,2299,48.91489361702128,0
2,3,471,1175,29,0.4005102040816326,1646,54.86666666666667,0
1,1,1359,601,26,2.2574750830564785,1960,72.5925925925926,0
1,3,609,734,51,0.8285714285714286,1343,25.826923076923077,0
0,3,29,791,8,0.036616161616161616,820,91.11111111111111,0
0,3,2524,108,7,23.155963302752294,2632,329.0,0
2,2,563,171,14,3.2732558139534884,734,48.93333333333333,0
1,0,227,592,2,0.3827993254637437,819,273.0,0
0,0,811,97,12,8.275510204081632,908,69.84615384615384,0
2,3,247,2681,15,0.09209545115585384,2928,183.0,0
1,2,230,566,20,0.4056437389770723,796,37.904761904761905,0
2,1,789,382,8,2.060052219321149,1171,130.11111111111111,0
0,3,496,137,71,3.5942028985507246,633,8.791666666666666,0
0,1,850,431,10,1.9675925925925926,1281,116.45454545454545,0
1,1,5752,288,57,19.903114186851212,6040,104.13793103448276,0
2,2,1959,73,17,26.472972972972972,2032,112.88888888888889,1
1,2,7,2729,37,0.002564102564102564,2736,72.0,0
0,0,51,246,3,0.20647773279352227,297,74.25,0
0,0,941,938,23,1.0021299254526093,1879,78.29166666666667,0
2,2,984,76,97,12.779220779220779,1060,10.816326530612244,1
2,3,2105,1955,32,1.0761758691206544,4060,123.03030303030303,0
2,0,991,714,51,1.386013986013986,1705,32.78846153846154,0
1,1,258,855,9,0.3014018691588785,1113,111.3,0
2,3,632,1217,48,0.5188834154351396,1849,37.734693877551024,0
2,1,1655,744,12,2.221476510067114,2399,184.53846153846155,0
0,2,2561,58,19,43.40677966101695,2619,130.95,0
0,1,270,449,6,0.6,719,102.71428571428571,0
2,3,775,243,19,3.1762295081967213,1018,50.9,0
2,2,173,533,21,0.32397003745318353,706,32.09090909090909,0
0,3,687,414,29,1.655421686746988,1101,36.7,0
2,1,94,1401,60,0.06704707560627675,1495,24.508196721311474,0
1,3,2842,227,10,12.464912280701755,3069,279.0,1
1,2,1016,179,124,5.644444444444445,1195,9.56,0
1,1,1925,2537,56,0.7584712371946415,4462,78.28070175438596,1
2,1,6374,2388,15,2.6680619506069485,8762,547.625,1
0,0,201,4024,7,0.04993788819875777,4225,528.125,0
2,0,1184,672,2,1.7592867756315007,1856,618.6666666666666,0
2,3,2180,96,8,22.47422680412371,2276,252.88888888888889,0
0,0,857,1697,64,0.5047114252061249,2554,39.292307692307695,0
0,0,1020,125,10,8.095238095238095,1145,104.0909090909091,0
0,0,523,135,4,3.8455882352941178,658,131.6,0
1,0,1123,171,0,6.52906976744186,1294,1294.0,0
2,2,503,847,10,0.5931603773584906,1350,122.72727272727273,0
0,2,647,90,7,7.1098901098901095,737,92.125,1
2,0,108,1205,3,0.08955223880597014,1313,328.25,0
1,3,7,48,90,0.14285714285714285,55,0.6043956043956044,0
1,2,56,93,9,0.5957446808510638,149,14.9,0
0,0,213,456,0,0.4660831509846827,669,669.0,0
0,2,609,381,86,1.594240837696335,990,11.379310344827585,0
2,1,21,3661,25,0.005734571272528673,3682,141.6153846153846,0
0,2,169,2725,2,0.061995597945708,2894,964.6666666666666,0
2,2,1520,168,0,8.994082840236686,1688,1688.0,0
0,3,1436,2344,3,0.612366737739872,3780,945.0,0
2,2,1559,942,26,1.653234358430541,2501,92.62962962962963,0
2,3,2545,420,1,6.045130641330166,2965,1482.5,1
2,1,126,1076,25,0.116991643454039,1202,46.23076923076923,0
2,0,178,1843,31,0.09652928416485901,2021,63.15625,0
1,3,405,158,4,2.547169811320755,563,112.6,0
2,2,2466,174,20,14.09142857142857,2640,125.71428571428571,0
0,2,1493,420,99,3.5463182897862233,1913,19.13,0
1,3,391,148,54,2.6241610738255035,539,9.8,0
1,1,91,357,38,0.2541899441340782,448,11.487179487179487,0
2,0,958,830,21,1.1528279181708785,1788,81.27272727272727,0
1,2,296,1340,15,0.22073079791200598,1636,102.25,0
2,1,757,287,18,2.6284722222222223,1044,54.94736842105263,0
0,0,2843,264,43,10.728301886792453,3107,70.61363636363636,0
2,0,850,1210,24,0.7018992568125516,2060,82.4,0
1,2,2574,383,43,6.703125,2957,67.20454545454545,0
0,3,499,1365,105,0.36530014641288433,1864,17.58490566037736,0
2,2,1003,4014,30,0.249813200498132,5017,161.83870967741936,1
0,2,2243,3116,27,0.7196021815848572,5359,191.39285714285714,0
0,2,886,869,15,1.0183908045977013,1755,109.6875,0
1,1,954,376,6,2.5305039787798407,1330,190.0,0
0,3,1259,54,14,22.89090909090909,1313,87.53333333333333,0
1,1,2137,1071,22,1.9934701492537314,3208,139.47826086956522,0
0,2,92,3052,1,0.03013429413691451,3144,1572.0,0
2,3,410,56,19,7.192982456140351,466,23.3,0
0,0,506,4,59,101.2,510,8.5,1
2,3,2404,1425,112,1.6858345021037868,3829,33.88495575221239,0
2,2,3123,86,58,35.89655172413793,3209,54.389830508474574,1
0,3,128,68,5,1.855072463768116,196,32.666666666666664,0
2,0,126,1929,5,0.06528497409326425,2055,342.5,0
0,0,2731,66,14,40.76119402985075,2797,186.46666666666667,1
0,3,350,96,7,3.6082474226804124,446,55.75,1
2,0,276,674,33,0.4088888888888889,950,27.941176470588236,0
2,1,36,1131,2,0.03180212014134275,1167,389.0,0
1,3,322,408,17,0.7872860635696821,730,40.55555555555556,0
2,0,1182,436,9,2.7048054919908466,1618,161.8,0
1,0,555,801,27,0.6920199501246883,1356,48.42857142857143,0
2,3,727,563,47,1.2890070921985815,1290,26.875,0
0,1,2492,15,77,155.75,2507,32.14102564102564,0
2,3,121,96,99,1.2474226804123711,217,2.17,0
0,0,73,697,12,0.10458452722063037,770,59.23076923076923,0
0,3,1910,1262,58,1.5122723673792557,3172,53.76271186440678,0
0,0,1491,1152,26,1.293148308759757,2643,97.88888888888889,0
1,2,306,1077,35,0.28385899814471244,1383,38.416666666666664,0
2,3,391,1180,57,0.3310753598645216,1571,27.086206896551722,0
0,3,371,36,4,10.027027027027026,407,81.4,0
0,0,1043,1803,88,0.5781596452328159,2846,31.97752808988764,0
1,0,63,1760,23,0.03577512776831346,1823,75.95833333333333,0
2,0,672,607,12,1.105263157894737,1279,98.38461538461539,0
2,0,143,228,12,0.6244541484716157,371,28.53846153846154,0
1,3,1713,717,41,2.385793871866295,2430,57.857142857142854,0
1,0,479,652,34,0.7335375191424196,1131,32.31428571428572,0
2,3,749,201,39,3.707920792079208,950,23.75,0
1,1,29,739,8,0.03918918918918919,768,85.33333333333333,0
2,3,60,1276,5,0.04698512137823023,1336,222.66666666666666,0
2,0,1124,1312,38,0.856054836252856,2436,62.46153846153846,0
0,0,1455,49,10,29.1,1504,136.72727272727272,0
0,1,1237,175,7,7.028409090909091,1412,176.5,1
2,3,1335,882,7,1.5118912797281994,2217,277.125,0
2,1,110,1571,4,0.06997455470737914,1681,336.2,0
2,3,1182,589,16,2.0033898305084747,1771,104.17647058823529,0
2,0,200,983,9,0.2032520325203252,1183,118.3,0
2,3,103,17,67,5.722222222222222,120,1.7647058823529411,0
2,0,1415,750,35,1.8841544607190412,2165,60.138888888888886,0
1,0,2201,2614,40,0.8416826003824092,4815,117.4390243902439,0
2,2,1261,865,15,1.456120092378753,2126,132.875,0
1,2,1637,2043,27,0.800880626223092,3680,131.42857142857142,0
1,3,4720,667,20,7.065868263473054,5387,256.5238095238095,0
2,0,144,1483,5,0.09703504043126684,1627,271.1666666666667,0
2,1,3356,106,1,31.364485981308412,3462,1731.0,1
1,0,919,105,34,8.669811320754716,1024,29.257142857142856,0
1,1,1678,102,3,16.29126213592233,1780,445.0,0
2,3,1050,536,1,1.9553072625698324,1586,793.0,0
2,3,844,320,17,2.629283489096573,1164,64.66666666666667,0
1,1,1216,1016,40,1.1956735496558506,2232,54.4390243902439,0
1,1,386,1863,43,0.20708154506437768,2249,51.11363636363637,0
1,0,2580,772,62,3.3376455368693403,3352,53.20634920634921,1
0,3,122,191,6,0.6354166666666666,313,44.714285714285715,0
1,0,382,2137,127,0.17867165575304023,2519,19.6796875,0
0,1,31,600,43,0.051580698835274545,631,14.340909090909092,0
2,2,316,1018,5,0.310107948969578,1334,222.33333333333334,0
2,2,246,1769,55,0.13898305084745763,2015,35.982142857142854,0
1,2,50,3670,20,0.013620266957232362,3720,177.14285714285714,0
2,1,676,564,2,1.1964601769911505,1240,413.3333333333333,0
2,0,632,1320,4,0.4784254352763058,1952,390.4,0
2,3,80,669,17,0.11940298507462686,749,41.611111111111114,0
2,1,303,533,22,0.5674157303370787,836,36.34782608695652,0
0,2,3064,617,88,4.957928802588997,3681,41.359550561797754,0
0,0,117,529,7,0.22075471698113208,646,80.75,0
1,3,363,437,19,0.8287671232876712,800,40.0,0
1,3,36,1029,7,0.03495145631067961,1065,133.125,0
1,1,161,229,24,0.7,390,15.6,0
2,1,1201,766,72,1.5658409387222947,1967,26.945205479452056,0
2,3,456,998,25,0.45645645645645644,1454,55.92307692307692,0
0,3,601,1781,21,0.3372615039281706,2382,108.27272727272727,0
0,2,170,322,41,0.5263157894736842,492,11.714285714285714,0
1,3,1146,1576,4,0.7266962587190868,2722,544.4,0
0,1,1392,2324,70,0.5987096774193549,3716,52.33802816901409,0
0,0,199,836,25,0.23775388291517324,1035,39.80769230769231,0
0,2,46,1180,34,0.03895004233700254,1226,35.02857142857143,0
0,2,84,416,51,0.2014388489208633,500,9.615384615384615,0
0,3,1070,2431,30,0.4399671052631579,3501,112.93548387096774,0
1,0,145,889,30,0.16292134831460675,1034,33.354838709677416,0
1,2,681,297,39,2.285234899328859,978,24.45,0
0,1,165,414,1,0.39759036144578314,579,289.5,0
1,3,186,769,14,0.24155844155844156,955,63.666666666666664,0
2,1,4,213,98,0.018691588785046728,217,2.191919191919192,0
0,3,386,1121,8,0.34402852049910876,1507,167.44444444444446,0
2,2,94,203,23,0.46078431372549017,297,12.375,0
1,3,500,716,5,0.697350069735007,1216,202.66666666666666,0
1,0,910,955,11,0.9518828451882845,1865,155.41666666666666,0
2,1,458,1571,37,0.2913486005089059,2029,53.39473684210526,0
1,0,1221,1059,30,1.1518867924528302,2280,73.54838709677419,0
0,1,1352,1282,16,1.053780202650039,2634,154.94117647058823,0
2,1,1192,1952,83,0.6103430619559652,3144,37.42857142857143,0
0,3,2760,728,44,3.786008230452675,3488,77.5111111111111,0
2,2,270,1498,9,0.1801200800533689,1768,176.8,0
1,2,210,211,18,0.9905660377358491,421,22.157894736842106,0
2,0,940,1348,63,0.6968124536693847,2288,35.75,0
2,3,903,200,0,4.492537313432836,1103,1103.0,1
0,2,713,2182,26,0.3266147503435639,2895,107.22222222222223,0
1,1,4,320,7,0.012461059190031152,324,40.5,0
0,1,810,150,1,5.364238410596027,960,480.0,0
1,3,2700,128,73,20.930232558139537,2828,38.21621621621622,0
0,0,407,165,50,2.4518072289156625,572,11.215686274509803,0
2,3,3429,474,6,7.218947368421053,3903,557.5714285714286,0
0,0,441,590,54,0.7461928934010152,1031,18.745454545454546,0
1,3,150,1960,4,0.0764915859255482,2110,422.0,0
1,1,508,383,19,1.3229166666666667,891,44.55,0
2,3,682,196,38,3.4619289340101522,878,22.512820512820515,0
1,2,992,1089,22,0.9100917431192661,2081,90.47826086956522,0
0,2,702,115,57,6.051724137931035,817,14.086206896551724,0
2,3,769,1782,28,0.43129556926528323,2551,87.96551724137932,0
1,0,24,421,16,0.05687203791469194,445,26.176470588235293,0
1,0,292,761,77,0.38320209973753283,1053,13.5,0
0,1,372,164,1,2.2545454545454544,536,268.0,0
0,1,4349,125,20,34.51587301587302,4474,213.04761904761904,0
2,0,350,1282,32,0.2727981293842556,1632,49.45454545454545,0
1,3,2268,449,54,5.04,2717,49.4,0
0,1,363,3458,23,0.1049436253252385,3821,159.20833333333334,0
2,0,101,594,65,0.16974789915966387,695,10.530303030303031,0
1,0,284,1494,16,0.18996655518394648,1778,104.58823529411765,0
1,3,318,3128,11,0.10162991371045062,3446,287.1666666666667,0
2,2,3828,264,109,14.445283018867924,4092,37.2,1
2,0,1121,1291,33,0.8676470588235294,2412,70.94117647058823,0
0,1,2683,17,16,149.05555555555554,2700,158.8235294117647,0
1,3,1801,910,63,1.9769484083424809,2711,42.359375,0
1,3,864,1093,34,0.7897623400365631,1957,55.91428571428571,0
1,3,1125,519,30,2.1634615384615383,1644,53.03225806451613,0
2,2,980,141,39,6.901408450704225,1121,28.025,0
0,2,1097,767,40,1.4283854166666667,1864,45.46341463414634,0
1,1,307,1822,20,0.16840373011519474,2129,101.38095238095238,0
2,1,524,2142,16,0.24451703219785348,2666,156.8235294117647,0
1,3,897,1096,72,0.8176845943482224,1993,27.301369863013697,0
0,1,36,244,20,0.1469387755102041,280,13.333333333333334,0
1,0,659,1634,7,0.40305810397553515,2293,286.625,0
0,2,1964,1757,22,1.117178612059158,3721,161.7826086956522,0
0,3,677,366,1,1.8446866485013624,1043,521.5,0
1,3,803,161,38,4.95679012345679,964,24.71794871794872,0
1,0,225,1661,4,0.13537906137184116,1886,377.2,0
0,0,1581,1730,3,0.9133448873483535,3311,827.75,0
2,0,444,85,87,5.162790697674419,529,6.011363636363637,0
0,0,3137,2728,44,1.1495053133015756,5865,130.33333333333334,1
1,3,5069,609,16,8.309836065573771,5678,334.0,1
1,2,2476,4057,8,0.610152784622967,6533,725.8888888888889,1
2,2,88,471,55,0.1864406779661017,559,9.982142857142858,0
0,0,405,609,103,0.6639344262295082,1014,9.75,0
0,1,2902,247,21,11.701612903225806,3149,143.13636363636363,0
0,3,1632,1833,26,0.8898582333696837,3465,128.33333333333334,0
1,2,2421,469,8,5.151063829787234,2890,321.1111111111111,0
0,0,849,1348,26,0.6293550778354337,2197,81.37037037037037,0
2,1,654,66,15,9.761194029850746,720,45.0,0
1,1,112,1241,56,0.09017713365539452,1353,23.736842105263158,0
1,0,1829,539,14,3.387037037037037,2368,157.86666666666667,1
0,3,1367,4,31,273.4,1371,42.84375,1
2,2,60,205,6,0.2912621359223301,265,37.857142857142854,0
1,1,234,172,2,1.3526011560693643,406,135.33333333333334,0
1,2,814,1114,1,0.7300448430493274,1928,964.0,0
0,2,1153,518,16,2.2215799614643545,1671,98.29411764705883,0
0,1,148,139,5,1.0571428571428572,287,47.833333333333336,0
2,0,280,237,150,1.1764705882352942,517,3.423841059602649,0
0,1,214,561,48,0.3807829181494662,775,15.816326530612244,0
2,1,248,15,35,15.5,263,7.305555555555555,0
1,3,2534,441,48,5.733031674208145,2975,60.714285714285715,0
2,2,1258,906,9,1.3869900771775083,2164,216.4,0
2,0,1336,583,63,2.287671232876712,1919,29.984375,0
2,2,1579,729,163,2.163013698630137,2308,14.073170731707316,0
1,1,440,316,10,1.38801261829653,756,68.72727272727273,0
0,0,1457,161,125,8.993827160493828,1618,12.841269841269842,1
1,0,3835,1327,11,2.887801204819277,5162,430.1666666666667,1
0,0,1198,1888,0,0.6341979883536263,3086,3086.0,0
2,0,539,571,13,0.9423076923076923,1110,79.28571428571429,0
2,3,1260,291,179,4.315068493150685,1551,8.616666666666667,0
2,0,2310,572,30,4.031413612565445,2882,92.96774193548387,0
2,1,137,1689,35,0.08106508875739644,1826,50.72222222222222,0
2,3,308,940,8,0.3273113708820404,1248,138.66666666666666,0
0,1,2516,1565,4,1.6066411238825031,4081,816.2,0
0,1,2923,318,65,9.163009404388715,3241,49.10606060606061,0
2,2,661,995,16,0.6636546184738956,1656,97.41176470588235,0
1,0,469,846,0,0.5537190082644629,1315,1315.0,0
1,0,332,678,10,0.4889543446244477,1010,91.81818181818181,0
2,1,690,601,6,1.1461794019933556,1291,184.42857142857142,0
0,0,2726,640,27,4.252730109204368,3366,120.21428571428571,0
1,3,162,1515,42,0.10686015831134564,1677,39.0,0
1,2,544,1981,20,0.27447023208879917,2525,120.23809523809524,0
1,0,2425,95,6,25.260416666666668,2520,360.0,1
2,0,429,672,1,0.637444279346211,1101,550.5,0
1,3,1461,2004,11,0.7286783042394015,3465,288.75,0
1,2,493,115,49,4.25,608,12.16,0
1,3,1634,425,16,3.835680751173709,2059,121.11764705882354,0
1,1,3963,74,8,52.84,4037,448.55555555555554,0
0,1,490,96,0,5.051546391752577,586,586.0,0
2,0,1864,1875,20,0.9936034115138592,3739,178.04761904761904,0
2,2,4458,472,34,9.424947145877379,4930,140.85714285714286,1
0,1,4124,933,6,4.415417558886509,5057,722.4285714285714,1
0,3,568,119,23,4.733333333333333,687,28.625,0
2,1,665,17,16,36.94444444444444,682,40.11764705882353,0
1,1,361,1769,36,0.20395480225988702,2130,57.567567567567565,0
1,3,376,683,59,0.5497076023391813,1059,17.65,0
2,0,678,16,11,39.88235294117647,694,57.833333333333336,1
1,2,223,3897,70,0.05720882503848127,4120,58.028169014084504,0
0,0,1241,542,36,2.285451197053407,1783,48.189189189189186,0
1,3,768,516,1,1.4854932301740813,1284,642.0,0
1,1,2283,775,46,2.9420103092783507,3058,65.06382978723404,0
1,2,1663,6,20,237.57142857142858,1669,79.47619047619048,0
2,0,389,673,87,0.5771513353115727,1062,12.068181818181818,0
0,3,704,794,11,0.8855345911949686,1498,124.83333333333333,0
1,1,1388,281,26,4.921985815602837,1669,61.81481481481482,0
2,1,214,1038,93,0.20596727622714148,1252,13.319148936170214,0
1,0,32,379,9,0.08421052631578947,411,41.1,0
0,3,1912,1012,19,1.8874629812438302,2924,146.2,0
1,1,147,124,41,1.176,271,6.4523809523809526,0
0,1,2201,1959,35,1.1229591836734694,4160,115.55555555555556,0
1,2,2448,1692,54,1.4459539279385707,4140,75.27272727272727,0
0,1,617,130,22,4.709923664122138,747,32.47826086956522,0
1,0,1643,2230,11,0.7364410578216046,3873,322.75,0
0,3,451,652,22,0.6906584992343032,1103,47.95652173913044,0
1,3,1953,967,12,2.0175619834710745,2920,224.6153846153846,0
1,2,1741,1467,5,1.185967302452316,3208,534.6666666666666,0
2,3,81,69,24,1.1571428571428573,150,6.0,0
2,0,873,148,1,5.859060402684563,1021,510.5,1
0,1,1021,274,1,3.712727272727273,1295,647.5,0
1,2,0,518,2,0.0,518,172.66666666666666,0
0,3,3907,339,33,11.491176470588234,4246,124.88235294117646,0
2,2,521,563,15,0.9237588652482269,1084,67.75,0
0,2,728,164,20,4.412121212121212,892,42.476190476190474,0
0,3,216,916,12,0.23555070883315157,1132,87.07692307692308,0
2,2,943,45,8,20.5,988,109.77777777777777,0
1,3,1663,358,13,4.632311977715878,2021,144.35714285714286,0
0,0,881,157,6,5.575949367088608,1038,148.28571428571428,0
2,3,1551,1047,34,1.4799618320610688,2598,74.22857142857143,0
1,1,1313,1720,3,0.7629285299244625,3033,758.25,0
2,3,271,65,21,4.106060606060606,336,15.272727272727273,0
0,1,572,1229,19,0.46504065040650405,1801,90.05,0
1,2,160,1808,10,0.08844665561083472,1968,178.9090909090909,0
1,3,42,2918,3,0.014388489208633094,2960,740.0,0
2,1,65,692,36,0.09379509379509379,757,20.45945945945946,0
2,3,2855,317,25,8.977987421383649,3172,122.0,0
2,3,4169,310,49,13.405144694533762,4479,89.58,1
1,3,99,381,8,0.2591623036649215,480,53.333333333333336,0
1,0,408,758,47,0.5375494071146245,1166,24.291666666666668,0
0,1,121,539,10,0.22407407407407406,660,60.0,0
1,0,1797,848,3,2.11660777385159,2645,661.25,0
0,0,685,32,4,20.757575757575758,717,143.4,0
2,1,970,89,7,10.777777777777779,1059,132.375,0
2,3,776,3001,34,0.25849433710859426,3777,107.91428571428571,0
1,0,1238,4302,8,0.287706251452475,5540,615.5555555555555,0
2,0,384,1098,27,0.3494085532302093,1482,52.92857142857143,0
2,0,147,236,8,0.620253164556962,383,42.55555555555556,0
1,3,17,2452,13,0.006930289441500204,2469,176.35714285714286,0
0,0,590,192,66,3.05699481865285,782,11.671641791044776,1
1,2,2384,1051,20,2.2661596958174903,3435,163.57142857142858,0
0,1,364,97,27,3.7142857142857144,461,16.464285714285715,0
1,2,218,837,6,0.26014319809069214,1055,150.71428571428572,0
1,3,2604,1140,4,2.2822085889570554,3744,748.8,0
2,0,111,1570,15,0.07065563335455124,1681,105.0625,0
1,1,53,1060,58,0.04995287464655985,1113,18.864406779661017,0
1,0,2115,2056,8,1.0281964025279533,4171,463.44444444444446,0
0,3,1207,588,29,2.0492359932088284,1795,59.833333333333336,0
2,1,548,905,61,0.6048565121412803,1453,23.43548387096774,0
0,2,1395,369,81,3.77027027027027,1764,21.51219512195122,0
0,1,1352,8,152,150.22222222222223,1360,8.88888888888889,0
2,0,40,1130,43,0.03536693191865606,1170,26.59090909090909,0
2,1,1127,1631,2,0.6905637254901961,2758,919.3333333333334,0
2,3,1024,152,61,6.69281045751634,1176,18.967741935483872,0
1,3,3318,23,65,138.25,3341,50.621212121212125,1
2,1,3399,143,24,23.604166666666668,3542,141.68,0
2,3,474,1805,2,0.26245847176079734,2279,759.6666666666666,0
2,3,891,280,19,3.170818505338078,1171,58.55,0
0,3,152,212,7,0.7136150234741784,364,45.5,0
0,2,68,11,17,5.666666666666667,79,4.388888888888889,0
1,0,567,281,38,2.0106382978723403,848,21.743589743589745,0
0,3,1170,1006,33,1.1618669314796426,2176,64.0,0
1,1,838,2557,45,0.3275996872556685,3395,73.80434782608695,0
0,3,561,300,19,1.8637873754152825,861,43.05,0
2,2,1704,220,21,7.710407239819005,1924,87.45454545454545,0
0,1,1581,1751,82,0.9023972602739726,3332,40.144578313253014,0
1,0,1316,1531,29,0.8590078328981723,2847,94.9,0
0,1,80,318,41,0.2507836990595611,398,9.476190476190476,0
2,1,1591,57,32,27.43103448275862,1648,49.93939393939394,0
1,1,2518,3861,30,0.6519937856033143,6379,205.7741935483871,0
2,1,61,913,73,0.06673960612691467,974,13.162162162162161,0
2,3,513,2089,13,0.24545454545454545,2602,185.85714285714286,0
1,0,4452,334,16,13.289552238805971,4786,281.52941176470586,0
2,3,914,834,14,1.0946107784431138,1748,116.53333333333333,0
2,2,720,897,43,0.8017817371937639,1617,36.75,0
0,2,195,1650,60,0.11811023622047244,1845,30.24590163934426,0
2,1,833,3976,13,0.20945436258486297,4809,343.5,0
2,3,578,92,4,6.21505376344086,670,134.0,1
2,3,136,797,20,0.17042606516290726,933,44.42857142857143,0
2,0,624,328,124,1.8966565349544073,952,7.616,0
1,0,179,1335,6,0.1339820359281437,1514,216.28571428571428,0
0,0,1311,1122,18,1.1674087266251114,2433,128.05263157894737,0
2,3,3636,1784,9,2.0369747899159663,5420,542.0,0
2,0,634,336,76,1.8813056379821957,970,12.597402597402597,0
1,0,1000,163,24,6.097560975609756,1163,46.52,1
2,0,563,17,25,31.27777777777778,580,22.307692307692307,0
1,1,149,236,0,0.6286919831223629,385,385.0,0
0,2,3525,366,31,9.60490463215259,3891,121.59375,0
0,2,138,2336,10,0.059050064184852376,2474,224.9090909090909,0
2,3,118,540,21,0.21811460258780038,658,29.90909090909091,0
2,3,614,650,22,0.9431643625192012,1264,54.95652173913044,0
2,1,1075,1697,26,0.633097762073027,2772,102.66666666666667,0
1,2,438,1730,52,0.2530329289428076,2168,40.905660377358494,0
2,0,213,600,10,0.3544093178036606,813,73.9090909090909,0
2,0,1709,96,8,17.61855670103093,1805,200.55555555555554,1
0,3,451,252,47,1.7826086956521738,703,14.645833333333334,0
2,2,216,488,38,0.44171779141104295,704,18.05128205128205,0
0,3,454,1112,7,0.4079065588499551,1566,195.75,0
2,3,241,994,0,0.2422110552763819,1235,1235.0,0
0,0,732,823,32,0.8883495145631068,1555,47.121212121212125,0
2,0,1103,1697,5,0.649587750294464,2800,466.6666666666667,0
0,2,1607,1298,94,1.237105465742879,2905,30.57894736842105,0
1,3,258,3219,27,0.08012422360248447,3477,124.17857142857143,0
0,1,182,1759,56,0.10340909090909091,1941,34.05263157894737,0
0,2,19,174,49,0.10857142857142857,193,3.86,0
0,3,258,47,24,5.375,305,12.2,0
2,2,24,428,17,0.055944055944055944,452,25.11111111111111,0
2,2,423,768,20,0.5500650195058517,1191,56.714285714285715,0
2,2,157,824,48,0.1903030303030303,981,20.020408163265305,0
1,1,867,249,30,3.468,1116,36.0,1
1,1,484,1572,6,0.3076923076923077,2056,293.7142857142857,0
0,0,98,319,28,0.30625,417,14.379310344827585,0
1,0,510,2011,15,0.25347912524850896,2521,157.5625,0
0,3,234,510,1,0.45792563600782776,744,372.0,0
0,2,1139,8,14,126.55555555555556,1147,76.46666666666667,0
0,3,453,141,7,3.1901408450704225,594,74.25,1
1,0,159,86,54,1.8275862068965518,245,4.454545454545454,0
2,1,430,36,3,11.621621621621621,466,116.5,1
1,0,254,1001,13,0.25349301397205587,1255,89.64285714285714,0
0,3,1588,170,35,9.286549707602338,1758,48.833333333333336,1
0,0,4096,1459,68,2.8054794520547945,5555,80.5072463768116,1
1,3,25,245,12,0.1016260162601626,270,20.76923076923077,0
0,3,1171,26,27,43.370370370370374,1197,42.75,0
0,3,306,1374,14,0.22254545454545455,1680,112.0,0
1,3,68,502,6,0.13518886679920478,570,81.42857142857143,0
1,0,14,732,11,0.019099590723055934,746,62.166666666666664,0
1,3,2128,327,30,6.487804878048781,2455,79.19354838709677,1
0,3,436,37,37,11.473684210526315,473,12.447368421052632,0
0,2,5211,369,13,14.083783783783783,5580,398.57142857142856,1
2,3,584,584,4,0.9982905982905983,1168,233.6,0
2,0,207,9,4,20.7,216,43.2,0
1,3,1501,683,50,2.1944444444444446,2184,42.8235294117647,0
2,1,2610,1788,31,1.4589155953046395,4398,137.4375,0
0,1,1690,196,39,8.578680203045685,1886,47.15,0
2,3,1367,2091,20,0.6534416826003824,3458,164.66666666666666,0
0,1,407,82,18,4.903614457831325,489,25.736842105263158,0
1,1,66,1396,7,0.047244094488188976,1462,182.75,0
1,0,224,1467,5,0.15258855585831063,1691,281.8333333333333,0
0,2,592,238,5,2.4769874476987446,830,138.33333333333334,0
2,1,3128,2533,144,1.2344119968429361,5661,39.04137931034483,0
1,1,1283,431,51,2.9699074074074074,1714,32.96153846153846,0
1,2,1761,121,29,14.434426229508198,1882,62.733333333333334,0
2,2,324,716,7,0.45188284518828453,1040,130.0,0
2,1,1151,4550,12,0.25291144803339927,5701,438.53846153846155,0
0,3,1983,1836,12,1.0794774088187262,3819,293.7692307692308,0
2,1,652,261,19,2.4885496183206106,913,45.65,0
2,3,561,688,16,0.8142235123367199,1249,73.47058823529412,0
2,3,1270,98,81,12.828282828282829,1368,16.682926829268293,1
0,3,820,495,38,1.653225806451613,1315,33.717948717948715,0
0,2,4986,592,2,8.408094435075885,5578,1859.3333333333333,1
1,1,553,302,13,1.825082508250825,855,61.07142857142857,0
0,1,193,529,4,0.3641509433962264,722,144.4,0
1,0,638,2019,9,0.31584158415841584,2657,265.7,0
2,2,268,554,95,0.4828828828828829,822,8.5625,0
1,0,823,1422,36,0.5783555867884751,2245,60.67567567567568,0
1,0,134,305,0,0.43790849673202614,439,439.0,0
2,3,2995,2843,11,1.0530942334739803,5838,486.5,0
1,2,1964,78,17,24.860759493670887,2042,113.44444444444444,0
0,0,169,704,27,0.2397163120567376,873,31.178571428571427,0
0,1,189,1248,20,0.1513210568454764,1437,68.42857142857143,0
0,0,718,1345,2,0.5334323922734027,2063,687.6666666666666,0
0,2,1482,176,21,8.372881355932204,1658,75.36363636363636,0
1,1,247,410,4,0.6009732360097324,657,131.4,0
1,1,62,782,21,0.07918263090676884,844,38.36363636363637,0
2,1,788,303,8,2.5921052631578947,1091,121.22222222222223,0
1,3,1176,859,4,1.3674418604651162,2035,407.0,0
1,1,280,380,10,0.7349081364829396,660,60.0,0
1,3,1346,345,3,3.8901734104046244,1691,422.75,0
2,3,3008,91,10,32.69565217391305,3099,281.72727272727275,0
0,0,147,32,60,4.454545454545454,179,2.9344262295081966,0
1,0,715,1442,11,0.4954954954954955,2157,179.75,0
2,1,58,537,19,0.10780669144981413,595,29.75,0
2,2,231,662,22,0.34841628959276016,893,38.82608695652174,0
2,1,94,372,5,0.2520107238605898,466,77.66666666666667,0
0,0,517,117,17,4.38135593220339,634,35.22222222222222,0
1,1,1719,477,57,3.596234309623431,2196,37.86206896551724,0
2,0,860,208,2,4.114832535885167,1068,356.0,0
0,1,251,1454,76,0.1725085910652921,1705,22.142857142857142,0
2,2,40,3461,61,0.011554015020219527,3501,56.46774193548387,0
2,1,806,1759,58,0.45795454545454545,2565,43.47457627118644,0
2,2,142,601,6,0.23588039867109634,743,106.14285714285714,0
2,2,419,791,19,0.5290404040404041,1210,60.5,0
2,1,713,2367,28,0.30109797297297297,3080,106.20689655172414,0
0,2,2340,618,3,3.780290791599354,2958,739.5,1
1,2,85,814,24,0.10429447852760736,899,35.96,0
1,0,1104,793,54,1.3904282115869018,1897,34.49090909090909,0
1,0,14,985,82,0.014198782961460446,999,12.036144578313253,0
1,2,994,817,9,1.215158924205379,1811,181.1,0
0,3,801,888,10,0.9010123734533183,1689,153.54545454545453,0
0,1,1670,1035,9,1.611969111969112,2705,270.5,0
0,2,758,1324,4,0.5720754716981132,2082,416.4,0
2,1,434,412,16,1.0508474576271187,846,49.76470588235294,0
2,0,278,1095,46,0.25364963503649635,1373,29.21276595744681,0
2,1,89,84,37,1.0470588235294118,173,4.552631578947368,0
1,2,764,1671,69,0.4569377990430622,2435,34.785714285714285,0
2,2,2192,274,13,7.970909090909091,2466,176.14285714285714,0
1,2,723,413,25,1.7463768115942029,1136,43.69230769230769,0
2,2,1343,1302,43,1.0306983883346124,2645,60.11363636363637,0
1,3,354,810,68,0.436498150431566,1164,16.869565217391305,0
2,3,594,295,61,2.0067567567567566,889,14.338709677419354,0
2,3,392,204,18,1.9121951219512194,596,31.36842105263158,0
0,2,115,2530,71,0.04543658632951403,2645,36.736111111111114,0
2,3,539,73,17,7.283783783783784,612,34.0,1
2,1,1445,3,69,361.25,1448,20.685714285714287,1
0,2,502,894,45,0.5608938547486033,1396,30.347826086956523,0
1,0,1050,762,7,1.3761467889908257,1812,226.5,0
0,2,1421,1070,79,1.326797385620915,2491,31.1375,0
0,1,389,1052,8,0.3694207027540361,1441,160.11111111111111,0
1,3,1597,1591,71,1.0031407035175879,3188,44.27777777777778,0
2,2,413,2041,28,0.20225269343780608,2454,84.62068965517241,0
1,3,295,1193,33,0.24706867671691793,1488,43.76470588235294,0
2,2,251,211,3,1.1839622641509433,462,115.5,0
2,1,223,498,2,0.4468937875751503,721,240.33333333333334,0
1,2,1336,821,103,1.6253041362530414,2157,20.740384615384617,0
0,3,2184,620,12,3.5169082125603865,2804,215.69230769230768,0
1,3,262,138,55,1.8848920863309353,400,7.142857142857143,0
2,1,89,711,36,0.125,800,21.62162162162162,0
1,2,376,1740,27,0.21596783457782884,2116,75.57142857142857,0
1,0,1072,433,34,2.4700460829493087,1505,43.0,0
2,2,459,884,2,0.5186440677966102,1343,447.6666666666667,0
0,1,796,765,15,1.0391644908616189,1561,97.5625,0
1,0,1363,378,28,3.5963060686015833,1741,60.03448275862069,0
2,1,525,666,60,0.7871064467766117,1191,19.524590163934427,0
2,2,8094,188,37,42.82539682539682,8282,217.94736842105263,1
1,0,353,631,8,0.5585443037974683,984,109.33333333333333,0
0,1,3828,1282,125,2.9836321122369447,5110,40.55555555555556,1
1,3,226,1138,30,0.1984196663740123,1364,44.0,0
0,0,117,354,20,0.3295774647887324,471,22.428571428571427,0
0,0,1389,95,45,14.46875,1484,32.26086956521739,1
0,1,1211,1287,27,0.9402173913043478,2498,89.21428571428571,0
0,3,1666,246,37,6.744939271255061,1912,50.31578947368421,0
1,0,420,43,28,9.545454545454545,463,15.96551724137931,0
2,1,2670,471,5,5.656779661016949,3141,523.5,0
2,0,127,1076,23,0.11792014856081709,1203,50.125,0
2,0,30,1322,9,0.022675736961451247,1352,135.2,0
2,0,357,3222,25,0.11076636673906298,3579,137.65384615384616,0
2,3,1596,167,4,9.5,1763,352.6,0
2,2,1117,278,7,4.003584229390681,1395,174.375,0
1,2,573,752,49,0.7609561752988048,1325,26.5,0
0,3,296,1334,15,0.22172284644194756,1630,101.875,0
2,3,61,213,33,0.2850467289719626,274,8.058823529411764,0
1,1,411,421,20,0.9739336492890995,832,39.61904761904762,0
2,0,616,419,12,1.4666666666666666,1035,79.61538461538461,0
2,3,1161,1186,20,0.9780960404380792,2347,111.76190476190476,0
0,1,1038,220,50,4.6968325791855206,1258,24.666666666666668,0
0,2,2943,2772,9,1.0613054453660296,5715,571.5,0
0,2,105,571,16,0.18356643356643357,676,39.76470588235294,0
2,2,409,265,6,1.537593984962406,674,96.28571428571429,0
2,2,656,267,12,2.4477611940298507,923,71.0,0
2,1,1110,14,64,74.0,1124,17.29230769230769,0
0,0,684,943,46,0.7245762711864406,1627,34.61702127659574,0
1,1,2439,1196,14,2.037593984962406,3635,242.33333333333334,0
2,0,938,26,4,34.74074074074074,964,192.8,1
2,2,40,705,16,0.056657223796033995,745,43.8235294117647,0
2,3,120,1217,44,0.09852216748768473,1337,29.711111111111112,0
1,3,1400,377,1,3.7037037037037037,1777,888.5,0
2,3,1258,453,41,2.7709251101321586,1711,40.73809523809524,0
1,0,166,359,34,0.46111111111111114,525,15.0,0
2,2,60,303,2,0.19736842105263158,363,121.0,0
1,1,864,540,30,1.5970425138632163,1404,45.29032258064516,0
2,3,1009,145,10,6.910958904109589,1154,104.9090909090909,0
0,0,145,464,5,0.3118279569892473,609,101.5,0
0,3,641,2275,14,0.28163444639718804,2916,194.4,0
0,1,365,22,6,15.869565217391305,387,55.285714285714285,0
0,2,2678,144,52,18.46896551724138,2822,53.24528301886792,1
2,1,247,1202,40,0.2053200332502078,1449,35.34146341463415,0
0,2,1321,113,118,11.587719298245615,1434,12.050420168067227,0
1,2,730,253,22,2.874015748031496,983,42.73913043478261,0
0,2,11,485,2,0.02263374485596708,496,165.33333333333334,0
0,3,727,2294,13,0.3167755991285403,3021,215.78571428571428,0
0,1,104,162,54,0.6380368098159509,266,4.836363636363636,0
2,3,1076,2052,15,0.5241110569897711,3128,195.5,0
0,1,833,1014,18,0.8206896551724138,1847,97.21052631578948,0
1,0,10,889,15,0.011235955056179775,899,56.1875,0
0,0,229,1028,8,0.22254616132167152,1257,139.66666666666666,0
0,1,1497,25,2,57.57692307692308,1522,507.3333333333333,0
0,1,322,83,5,3.8333333333333335,405,67.5,0
1,1,691,326,13,2.1131498470948014,1017,72.64285714285714,0
0,1,373,61,8,6.016129032258065,434,48.22222222222222,0
1,2,2544,3511,25,0.724373576309795,6055,232.8846153846154,0
1,3,769,694,28,1.106474820143885,1463,50.44827586206897,0
0,2,1191,534,25,2.2261682242990655,1725,66.34615384615384,0
1,3,87,1231,2,0.07061688311688312,1318,439.3333333333333,0
2,3,41,3016,32,0.01358965860125953,3057,92.63636363636364,0
0,3,300,2483,14,0.12077294685990338,2783,185.53333333333333,0
0,2,369,1260,63,0.29262490087232357,1629,25.453125,0
1,1,1163,378,22,3.0686015831134563,1541,67.0,0
1,2,841,54,2,15.290909090909091,895,298.3333333333333,0
0,2,469,82,0,5.650602409638554,551,551.0,0
2,3,1061,0,36,1061.0,1061,28.675675675675677,0
1,0,178,1,15,89.0,179,11.1875,0
1,0,65,2204,10,0.02947845804988662,2269,206.27272727272728,0
2,2,1927,2094,17,0.9198090692124105,4021,223.38888888888889,0
2,3,829,881,2,0.9399092970521542,1710,570.0,0
0,2,1047,1037,14,1.0086705202312138,2084,138.93333333333334,0
2,2,367,575,11,0.6371527777777778,942,78.5,0
0,1,465,217,48,2.13302752293578,682,13.918367346938776,0
2,3,85,1966,5,0.043213014743263854,2051,341.8333333333333,0
1,0,1944,260,42,7.448275862068965,2204,51.25581395348837,0
0,0,897,1076,20,0.8328690807799443,1973,93.95238095238095,0
0,0,87,225,2,0.38495575221238937,312,104.0,0
0,2,1632,1633,104,0.9987760097919217,3265,31.095238095238095,0
2,3,587,842,39,0.6963226571767497,1429,35.725,0
1,1,1448,823,9,1.7572815533980584,2271,227.1,0
0,0,12,81,26,0.14634146341463414,93,3.4444444444444446,0
0,3,29,435,69,0.06651376146788991,464,6.628571428571429,0
0,0,187,595,80,0.313758389261745,782,9.654320987654321,0
0,1,236,278,39,0.8458781362007168,514,12.85,0
1,3,1443,1702,39,0.8473282442748091,3145,78.625,0
2,2,1226,1454,9,0.8426116838487973,2680,268.0,0
1,2,957,544,137,1.7559633027522936,1501,10.876811594202898,0
0,0,2161,332,8,6.48948948948949,2493,277.0,1
1,0,283,1293,2,0.2187017001545595,1576,525.3333333333334,0
0,3,2347,175,113,13.335227272727273,2522,22.12280701754386,0
2,1,2402,59,4,40.03333333333333,2461,492.2,0
2,0,569,37,22,14.973684210526315,606,26.347826086956523,0
2,3,99,31,18,3.09375,130,6.842105263157895,0
0,1,1296,536,56,2.4134078212290504,1832,32.14035087719298,0
1,0,410,235,15,1.7372881355932204,645,40.3125,0
2,0,1584,937,20,1.6886993603411513,2521,120.04761904761905,0
0,3,178,848,1,0.20965842167255594,1026,513.0,0
0,0,775,624,6,1.24,1399,199.85714285714286,0
1,2,709,348,53,2.031518624641834,1057,19.574074074074073,0
2,1,105,1520,19,0.06903353057199212,1625,81.25,0
0,1,451,989,7,0.45555555555555555,1440,180.0,0
1,2,88,253,13,0.3464566929133858,341,24.357142857142858,0
2,3,625,557,10,1.1200716845878136,1182,107.45454545454545,0
1,2,1850,135,24,13.602941176470589,1985,79.4,1
1,2,314,318,1,0.9843260188087775,632,316.0,0
0,1,1447,4685,7,0.30879214682031586,6132,766.5,0
0,3,202,202,13,0.9950738916256158,404,28.857142857142858,0
0,0,1120,958,79,1.167883211678832,2078,25.975,0
1,2,2471,217,29,11.3348623853211,2688,89.6,0
0,2,391,2226,21,0.17557251908396945,2617,118.95454545454545,0
1,3,2306,297,6,7.738255033557047,2603,371.85714285714283,0
1,2,704,340,24,2.064516129032258,1044,41.76,0
0,3,380,720,79,0.5270457697642164,1100,13.75,0
2,0,2268,709,25,3.1943661971830988,2977,114.5,1
2,3,32,692,5,0.046176046176046176,724,120.66666666666667,0
2,0,28,681,175,0.04105571847507331,709,4.028409090909091,0
1,3,915,299,20,3.05,1214,57.80952380952381,0
1,2,1593,455,11,3.4934210526315788,2048,170.66666666666666,1
1,0,1392,720,20,1.9306518723994452,2112,100.57142857142857,0
0,2,82,890,9,0.0920314253647587,972,97.2,0
1,0,3000,233,0,12.820512820512821,3233,3233.0,0
0,3,1214,967,66,1.2541322314049588,2181,32.55223880597015,0
0,3,2978,2054,16,1.4491484184914842,5032,296.0,0
2,3,399,1134,41,0.3515418502202643,1533,36.5,0
2,1,1183,70,106,16.661971830985916,1253,11.710280373831775,0
2,1,1965,506,30,3.8757396449704142,2471,79.70967741935483,0
0,0,478,457,35,1.0436681222707425,935,25.97222222222222,0
0,1,3348,328,86,10.17629179331307,3676,42.252873563218394,0
0,3,307,540,21,0.5674676524953789,847,38.5,0
1,1,379,463,11,0.8168103448275862,842,70.16666666666667,0
0,1,2529,4,76,505.8,2533,32.896103896103895,1
2,2,3495,215,2,16.180555555555557,3710,1236.6666666666667,0
2,0,335,192,7,1.7357512953367875,527,65.875,0
0,0,146,343,12,0.42441860465116277,489,37.61538461538461,0
0,0,1423,153,45,9.24025974025974,1576,34.26086956521739,1
2,1,2654,56,70,46.56140350877193,2710,38.16901408450704,0
0,3,918,175,18,5.215909090909091,1093,57.526315789473685,1
2,2,1006,1540,10,0.6528228423101882,2546,231.45454545454547,0
1,0,1439,1275,13,1.1277429467084639,2714,193.85714285714286,0
2,1,166,466,32,0.3554603854389722,632,19.151515151515152,0
1,3,3629,1681,5,2.157550535077289,5310,885.0,1
0,2,453,211,23,2.1367924528301887,664,27.666666666666668,0
0,2,989,702,26,1.406827880512091,1691,62.629629629629626,0
1,0,632,123,36,5.096774193548387,755,20.405405405405407,1
0,0,631,1433,27,0.4400278940027894,2064,73.71428571428571,0
1,3,1213,111,3,10.830357142857142,1324,331.0,0
0,1,5232,25,35,201.23076923076923,5257,146.02777777777777,0
2,3,1076,255,0,4.203125,1331,1331.0,1
0,0,1580,1849,14,0.8540540540540541,3429,228.6,0
2,3,28,110,16,0.25225225225225223,138,8.117647058823529,0
2,1,1662,321,3,5.161490683229814,1983,495.75,0
1,2,356,304,0,1.1672131147540983,660,660.0,0
0,2,135,1294,2,0.10424710424710425,1429,476.3333333333333,0
1,2,120,437,17,0.273972602739726,557,30.944444444444443,0
0,2,1139,756,8,1.5046235138705417,1895,210.55555555555554,0
2,0,6039,414,2,14.551807228915663,6453,2151.0,1
2,0,1097,641,8,1.7087227414330217,1738,193.11111111111111,0
0,1,304,51,22,5.846153846153846,355,15.434782608695652,1
0,1,227,374,40,0.6053333333333333,601,14.658536585365853,0
1,1,746,1545,15,0.48253557567917205,2291,143.1875,0
0,1,67,939,28,0.07127659574468086,1006,34.689655172413794,0
0,3,509,3206,27,0.15871531025880886,3715,132.67857142857142,0
0,1,1097,1240,67,0.8839645447219984,2337,34.36764705882353,0
1,2,3431,480,5,7.133056133056133,3911,651.8333333333334,1
0,2,554,902,19,0.6135105204872646,1456,72.8,0
2,2,223,1196,29,0.18629908103592313,1419,47.3,0
1,3,1700,251,22,6.746031746031746,1951,84.82608695652173,1
1,1,1363,49,17,27.26,1412,78.44444444444444,1
2,2,1964,416,108,4.709832134292566,2380,21.834862385321102,1
2,2,241,125,85,1.9126984126984128,366,4.255813953488372,0
2,2,518,259,28,1.9923076923076923,777,26.79310344827586,0
0,2,3992,2347,17,1.7001703577512777,6339,352.1666666666667,0
2,0,172,1502,42,0.11443779108449767,1674,38.93023255813954,0
0,1,1113,718,21,1.5479833101529903,1831,83.22727272727273,0
1,1,270,410,162,0.656934306569343,680,4.171779141104294,0
1,3,693,245,34,2.817073170731707,938,26.8,0
2,0,1611,677,2,2.3761061946902653,2288,762.6666666666666,0
0,3,670,609,15,1.098360655737705,1279,79.9375,0
2,2,1637,1214,39,1.3473251028806585,2851,71.275,0
2,3,555,2105,55,0.26353276353276356,2660,47.5,0
0,2,7343,319,50,22.946875,7662,150.23529411764707,0
2,2,572,184,113,3.091891891891892,756,6.631578947368421,0
1,1,161,412,20,0.3898305084745763,573,27.285714285714285,0
2,1,513,460,4,1.1127982646420824,973,194.6,0
0,1,1357,32,31,41.121212121212125,1389,43.40625,0
0,1,1883,1582,2,1.1895135818066962,3465,1155.0,0
1,1,616,4339,108,0.14193548387096774,4955,45.45871559633027,1
0,0,902,2053,42,0.439143135345667,2955,68.72093023255815,0
0,1,1863,1576,120,1.1813570069752695,3439,28.421487603305785,0
1,3,1679,3925,14,0.4276617422312787,5604,373.6,1
2,2,1072,1907,0,0.5618448637316562,2979,2979.0,0
1,1,1687,932,22,1.8081457663451233,2619,113.8695652173913,0
2,0,857,145,3,5.86986301369863,1002,250.5,1
1,3,4,136,34,0.029197080291970802,140,4.0,0
2,3,42,40,20,1.024390243902439,82,3.9047619047619047,0
1,2,3902,424,42,9.181176470588236,4326,100.6046511627907,1
2,3,156,1323,10,0.11782477341389729,1479,134.45454545454547,0
1,3,518,539,53,0.9592592592592593,1057,19.574074074074073,0
2,3,2715,364,31,7.438356164383562,3079,96.21875,1
1,3,216,92,131,2.3225806451612905,308,2.3333333333333335,0
0,0,1856,42,5,43.16279069767442,1898,316.3333333333333,0
2,2,1705,407,1,4.178921568627451,2112,1056.0,0
1,1,4292,84,57,50.49411764705882,4376,75.44827586206897,0
2,3,330,87,12,3.75,417,32.07692307692308,1
2,0,378,402,16,0.9379652605459057,780,45.88235294117647,0
1,2,2331,559,77,4.1625,2890,37.05128205128205,1
2,1,266,165,17,1.6024096385542168,431,23.944444444444443,0
1,2,793,923,10,0.8582251082251082,1716,156.0,0
0,0,1228,433,1,2.8294930875576036,1661,830.5,0
2,0,317,77,17,4.064102564102564,394,21.88888888888889,0
0,0,2787,810,31,3.436498150431566,3597,112.40625,0
2,3,1095,353,9,3.093220338983051,1448,144.8,0
2,0,48,42,37,1.1162790697674418,90,2.3684210526315788,0
2,1,145,2364,19,0.0613107822410148,2509,125.45,0
1,3,211,677,58,0.3112094395280236,888,15.05084745762712,0
0,2,280,519,5,0.5384615384615384,799,133.16666666666666,0
2,1,1311,1567,42,0.8360969387755102,2878,66.93023255813954,0
1,3,93,2208,80,0.04210049796287913,2301,28.40740740740741,0
2,0,431,199,40,2.155,630,15.365853658536585,0
1,2,2423,1329,15,1.8218045112781955,3752,234.5,0
2,0,813,1422,7,0.5713281799016163,2235,279.375,0
0,1,308,44,3,6.844444444444444,352,88.0,0
0,1,3147,995,30,3.1596385542168677,4142,133.61290322580646,0
2,3,280,52,4,5.283018867924528,332,66.4,0
1,1,2354,722,54,3.255878284923928,3076,55.92727272727273,0
2,2,1293,885,97,1.4593679458239277,2178,22.224489795918366,0
1,3,1349,365,4,3.685792349726776,1714,342.8,1
2,2,1447,1701,14,0.8501762632197415,3148,209.86666666666667,0
1,0,706,1289,83,0.5472868217054263,1995,23.75,0
0,2,1685,2082,19,0.8089294287085934,3767,188.35,0
2,2,1809,302,22,5.97029702970297,2111,91.78260869565217,1
0,1,447,17,41,24.833333333333332,464,11.047619047619047,1
0,0,511,1334,7,0.38277153558052435,1845,230.625,0
2,1,2196,201,116,10.871287128712872,2397,20.487179487179485,0
2,0,743,503,45,1.4742063492063493,1246,27.08695652173913,0
1,0,2016,1360,5,1.4812637766348273,3376,562.6666666666666,0
1,2,985,194,3,5.051282051282051,1179,294.75,0
0,1,900,299,81,3.0,1199,14.621951219512194,0
1,2,31,462,34,0.06695464362850972,493,14.085714285714285,0
1,2,325,253,1,1.279527559055118,578,289.0,0
2,2,697,494,4,1.408080808080808,1191,238.2,0
1,0,885,7,1,110.625,892,446.0,1
0,1,995,190,109,5.209424083769633,1185,10.772727272727273,0
1,1,1259,1429,20,0.8804195804195805,2688,128.0,0
0,2,1067,426,18,2.4988290398126463,1493,78.57894736842105,0
2,0,1887,809,93,2.3296296296296295,2696,28.680851063829788,0
0,1,350,211,21,1.650943396226415,561,25.5,0
1,3,1026,839,21,1.2214285714285715,1865,84.77272727272727,0
2,1,52,8441,124,0.006159677801468846,8493,67.944,1
1,2,654,723,3,0.9033149171270718,1377,344.25,0
2,3,312,791,127,0.3939393939393939,1103,8.6171875,0
2,0,479,94,5,5.042105263157895,573,95.5,0
1,3,437,413,19,1.0555555555555556,850,42.5,0
1,3,62,1577,12,0.03929024081115336,1639,126.07692307692308,0
2,2,628,1437,93,0.43671766342141866,2065,21.96808510638298,0
2,1,5226,591,19,8.827702702702704,5817,290.85,0
1,0,355,1870,0,0.1897381079636558,2225,2225.0,0
0,3,1332,123,7,10.741935483870968,1455,181.875,0
1,2,793,858,16,0.9231664726426076,1651,97.11764705882354,0
2,1,393,228,33,1.7161572052401746,621,18.264705882352942,0
1,3,93,829,24,0.11204819277108434,922,36.88,0
0,2,243,73,56,3.2837837837837838,316,5.543859649122807,0
1,2,1522,2300,52,0.661451542807475,3822,72.11320754716981,0
2,2,327,1234,26,0.2647773279352227,1561,57.81481481481482,0
1,0,155,179,25,0.8611111111111112,334,12.846153846153847,0
2,1,402,811,9,0.49507389162561577,1213,121.3,0
2,3,877,1138,95,0.7699736611062336,2015,20.989583333333332,0
1,1,1215,188,2,6.428571428571429,1403,467.6666666666667,0
2,1,489,78,15,6.189873417721519,567,35.4375,0
2,3,689,346,32,1.9855907780979827,1035,31.363636363636363,0
0,1,606,116,87,5.17948717948718,722,8.204545454545455,0
0,0,9,667,20,0.01347305389221557,676,32.19047619047619,0
0,3,503,441,67,1.1380090497737556,944,13.882352941176471,0
0,3,885,496,3,1.7806841046277666,1381,345.25,0
2,2,843,626,22,1.3444976076555024,1469,63.869565217391305,0
1,1,1385,3216,11,0.43052533416226296,4601,383.4166666666667,0
2,3,1109,1258,47,0.880857823669579,2367,49.3125,0
2,3,324,794,17,0.4075471698113208,1118,62.111111111111114,0
2,0,295,361,19,0.8149171270718232,656,32.8,0
1,2,623,21,2,28.318181818181817,644,214.66666666666666,0
0,3,1320,99,17,13.2,1419,78.83333333333333,0
2,0,98,1050,2,0.09324452901998097,1148,382.6666666666667,0
2,3,2962,368,10,8.02710027100271,3330,302.72727272727275,0
0,3,783,325,4,2.401840490797546,1108,221.6,0
2,3,365,1758,12,0.20750426378624218,2123,163.30769230769232,0
1,0,1182,530,7,2.225988700564972,1712,214.0,0
2,1,45,1838,10,0.024469820554649267,1883,171.1818181818182,0
2,3,662,1741,4,0.38002296211251435,2403,480.6,0
0,3,665,66,17,9.925373134328359,731,40.611111111111114,0
2,1,176,2325,20,0.07566638005159071,2501,119.0952380952381,0
2,3,1816,64,54,27.93846153846154,1880,34.18181818181818,1
1,2,1593,2648,23,0.6013590033975085,4241,176.70833333333334,0
0,3,165,482,7,0.3416149068322981,647,80.875,0
0,2,452,1144,39,0.3947598253275109,1596,39.9,0
1,1,105,979,10,0.10714285714285714,1084,98.54545454545455,0
2,0,1887,584,42,3.2256410256410257,2471,57.46511627906977,0
0,1,390,772,14,0.5045278137128072,1162,77.46666666666667,0
0,3,578,2395,21,0.24123539232053423,2973,135.13636363636363,0
2,2,391,2097,21,0.18636796949475692,2488,113.0909090909091,0
2,0,371,849,93,0.4364705882352941,1220,12.97872340425532,0
0,3,1375,857,5,1.6025641025641026,2232,372.0,0
2,0,1376,226,83,6.061674008810573,1602,19.071428571428573,0
0,0,729,1411,24,0.5162889518413598,2140,85.6,0
2,3,1071,801,151,1.3354114713216958,1872,12.31578947368421,0
2,1,716,1400,25,0.5110635260528195,2116,81.38461538461539,0
1,3,29,858,32,0.033760186263096625,887,26.87878787878788,0
2,3,68,284,41,0.23859649122807017,352,8.380952380952381,0
1,1,484,168,51,2.863905325443787,652,12.538461538461538,0
2,2,1385,64,19,21.307692307692307,1449,72.45,0
0,3,2444,705,34,3.461756373937677,3149,89.97142857142858,0
0,0,30,267,28,0.11194029850746269,297,10.241379310344827,0
2,3,458,796,15,0.5746549560853199,1254,78.375,0
2,3,253,48,51,5.163265306122449,301,5.788461538461538,0
0,0,1688,376,6,4.477453580901857,2064,294.85714285714283,0
2,1,1870,241,5,7.7272727272727275,2111,351.8333333333333,0
1,2,231,370,40,0.6226415094339622,601,14.658536585365853,0
1,2,1240,44,30,27.555555555555557,1284,41.41935483870968,0
1,0,1315,1030,11,1.2754607177497574,2345,195.41666666666666,0
1,1,194,99,30,1.94,293,9.451612903225806,0
1,3,568,11,44,47.333333333333336,579,12.866666666666667,0
2,3,968,2339,7,0.41367521367521365,3307,413.375,0
2,3,26,171,26,0.1511627906976744,197,7.296296296296297,0
1,3,518,1408,52,0.36763662171753014,1926,36.339622641509436,0
2,3,168,2669,15,0.06292134831460675,2837,177.3125,0
2,0,780,611,25,1.2745098039215685,1391,53.5,0
1,3,1850,597,2,3.0936454849498327,2447,815.6666666666666,0
2,3,743,366,53,2.024523160762943,1109,20.537037037037038,0
2,1,36,443,47,0.08108108108108109,479,9.979166666666666,0
2,3,30,526,18,0.056925996204933584,556,29.263157894736842,0
1,2,930,131,3,7.045454545454546,1061,265.25,0
2,0,397,362,32,1.09366391184573,759,23.0,0
0,0,850,1354,25,0.6273062730627307,2204,84.76923076923077,0
0,0,178,161,75,1.0987654320987654,339,4.4605263157894735,0
1,2,1499,1047,9,1.4303435114503817,2546,254.6,0
0,3,1971,843,0,2.335308056872038,2814,2814.0,0
1,0,2200,47,8,45.833333333333336,2247,249.66666666666666,1
0,2,362,18,16,19.05263157894737,380,22.352941176470587,1
0,1,1080,347,5,3.103448275862069,1427,237.83333333333334,0
0,3,327,942,116,0.34676564156945916,1269,10.846153846153847,0
1,2,1438,320,7,4.479750778816199,1758,219.75,0
1,3,128,881,33,0.14512471655328799,1009,29.676470588235293,0
2,1,1438,875,18,1.6415525114155252,2313,121.73684210526316,0
1,2,579,1314,24,0.4403041825095057,1893,75.72,0
0,3,1934,83,80,23.023809523809526,2017,24.901234567901234,1
0,2,1342,688,22,1.9477503628447024,2030,88.26086956521739,0
1,0,472,51,10,9.076923076923077,523,47.54545454545455,0
1,3,2338,154,7,15.083870967741936,2492,311.5,0
1,2,333,315,66,1.0537974683544304,648,9.671641791044776,0
2,0,3410,983,129,3.4654471544715446,4393,33.792307692307695,0
0,1,1457,2915,8,0.4996570644718793,4372,485.77777777777777,1
2,3,4675,335,38,13.913690476190476,5010,128.46153846153845,1
2,3,55,589,21,0.09322033898305085,644,29.272727272727273,0
0,1,320,239,35,1.3333333333333333,559,15.527777777777779,0
0,0,1351,900,99,1.4994450610432852,2251,22.51,0
1,1,2554,365,9,6.978142076502732,2919,291.9,0
1,3,29,525,40,0.055133079847908745,554,13.512195121951219,0
2,2,0,671,17,0.0,671,37.27777777777778,0
1,0,296,927,31,0.31896551724137934,1223,38.21875,0
1,0,1915,49,15,38.3,1964,122.75,0
0,0,1457,647,36,2.248456790123457,2104,56.86486486486486,0
0,1,415,451,12,0.918141592920354,866,66.61538461538461,0
1,1,2,114,20,0.017391304347826087,116,5.523809523809524,0
0,2,809,186,37,4.32620320855615,995,26.18421052631579,0
1,2,271,1722,1,0.15728380731282646,1993,996.5,0
0,0,1368,1643,11,0.8321167883211679,3011,250.91666666666666,0
0,2,591,27,23,21.107142857142858,618,25.75,0
0,1,1135,935,2,1.2126068376068375,2070,690.0,0
0,2,1912,646,36,2.955177743431221,2558,69.13513513513513,0
1,1,767,2248,50,0.34104046242774566,3015,59.11764705882353,0
2,2,409,1908,5,0.214248297537978,2317,386.1666666666667,0
0,3,1467,693,39,2.1138328530259365,2160,54.0,0
1,1,308,119,31,2.566666666666667,427,13.34375,0
1,3,2221,492,15,4.505070993914807,2713,169.5625,1
0,1,74,1033,5,0.07156673114119923,1107,184.5,0
2,2,1804,2424,92,0.7439175257731959,4228,45.46236559139785,0
0,3,96,361,18,0.26519337016574585,457,24.05263157894737,0
1,2,57,1228,6,0.046379170056956874,1285,183.57142857142858,0
2,1,451,919,37,0.4902173913043478,1370,36.05263157894737,0
1,3,3136,65,28,47.515151515151516,3201,110.37931034482759,0
0,0,4103,653,50,6.273700305810397,4756,93.25490196078431,1
2,2,225,162,166,1.3803680981595092,387,2.317365269461078,0
1,1,160,920,1,0.1737242128121607,1080,540.0,0
1,3,435,753,40,0.5769230769230769,1188,28.975609756097562,0
1,2,411,2890,135,0.1421653407125562,3301,24.272058823529413,0
0,3,1425,2191,23,0.6500912408759124,3616,150.66666666666666,0
2,2,586,7,37,73.25,593,15.605263157894736,1
0,2,1513,66,17,22.582089552238806,1579,87.72222222222223,0
0,2,1381,1172,13,1.1773231031543052,2553,182.35714285714286,0
0,3,863,925,35,0.9319654427645788,1788,49.666666666666664,0
2,3,1792,1291,132,1.3869969040247678,3083,23.18045112781955,0
0,2,217,248,2,0.8714859437751004,465,155.0,0
0,0,176,1514,16,0.11617161716171617,1690,99.41176470588235,0
0,0,1388,467,84,2.965811965811966,1855,21.823529411764707,0
0,0,280,242,3,1.1522633744855968,522,130.5,0
1,1,2,8,31,0.2222222222222222,10,0.3125,0
0,0,2429,1640,16,1.4801950030469226,4069,239.35294117647058,0
1,3,975,613,14,1.5879478827361564,1588,105.86666666666666,0
0,0,588,2963,7,0.19838056680161945,3551,443.875,0
2,3,1293,1003,5,1.2878486055776892,2296,382.6666666666667,0
1,1,405,67,21,5.955882352941177,472,21.454545454545453,0
1,3,3071,709,14,4.325352112676057,3780,252.0,0
1,3,71,13,20,5.071428571428571,84,4.0,0
1,3,1024,652,6,1.5681470137825422,1676,239.42857142857142,0
2,0,1501,344,12,4.350724637681159,1845,141.92307692307693,1
0,2,633,824,168,0.7672727272727272,1457,8.621301775147929,0
1,3,1406,623,13,2.253205128205128,2029,144.92857142857142,0
2,0,2616,242,15,10.765432098765432,2858,178.625,0
1,0,1362,141,0,9.591549295774648,1503,1503.0,1
0,0,370,414,14,0.891566265060241,784,52.266666666666666,0
1,2,825,3464,43,0.23809523809523808,4289,97.47727272727273,0
2,2,2425,457,21,5.294759825327511,2882,131.0,0
0,2,596,1105,32,0.538878842676311,1701,51.54545454545455,0
2,2,1144,46,24,24.340425531914892,1190,47.6,1
0,1,626,380,3,1.643044619422572,1006,251.5,0
0,2,129,694,12,0.1856115107913669,823,63.30769230769231,0
0,2,60,1112,35,0.05390835579514825,1172,32.55555555555556,0
1,2,3042,601,23,5.053156146179402,3643,151.79166666666666,0
2,3,948,579,33,1.6344827586206896,1527,44.911764705882355,0
2,3,109,1154,13,0.09437229437229437,1263,90.21428571428571,0
2,2,1947,300,6,6.46843853820598,2247,321.0,1
0,1,739,75,53,9.723684210526315,814,15.074074074074074,0
1,3,1478,341,14,4.321637426900585,1819,121.26666666666667,0
0,0,135,138,31,0.9712230215827338,273,8.53125,0
2,3,2374,2703,14,0.8779585798816568,5077,338.46666666666664,0
1,0,892,689,78,1.2927536231884058,1581,20.0126582278481,0
1,3,1340,473,144,2.827004219409283,1813,12.50344827586207,0
1,2,31,1944,31,0.015938303341902313,1975,61.71875,0
2,3,378,1844,27,0.2048780487804878,2222,79.35714285714286,0
1,2,311,429,55,0.7232558139534884,740,13.214285714285714,0
1,2,2987,1661,21,1.7972322503008424,4648,211.27272727272728,0
0,3,204,52,61,3.849056603773585,256,4.129032258064516,1
0,0,1227,1735,15,0.7067972350230415,2962,185.125,0
1,0,43,297,0,0.14429530201342283,340,340.0,0
1,3,220,666,78,0.32983508245877063,886,11.215189873417721,0
0,2,413,251,38,1.6388888888888888,664,17.025641025641026,0
0,0,1582,3349,21,0.4722388059701493,4931,224.13636363636363,0
0,1,1560,59,86,26.0,1619,18.60919540229885,0
2,2,3049,473,65,6.432489451476793,3522,53.36363636363637,0
2,3,2486,776,3,3.1994851994851996,3262,815.5,0
0,2,85,764,29,0.1111111111111111,849,28.3,0
1,1,1771,1073,23,1.648975791433892,2844,118.5,0
0,1,599,1031,44,0.5804263565891473,1630,36.22222222222222,0
2,0,2009,1260,10,1.5931800158604281,3269,297.1818181818182,0
1,1,93,213,0,0.43457943925233644,306,306.0,0
2,2,1730,370,6,4.663072776280323,2100,300.0,0
1,0,173,385,7,0.4481865284974093,558,69.75,0
2,1,406,2495,10,0.16266025641025642,2901,263.72727272727275,0
1,0,29,421,13,0.06872037914691943,450,32.142857142857146,0
1,0,132,200,36,0.6567164179104478,332,8.972972972972974,0
1,3,590,800,2,0.7365792759051186,1390,463.3333333333333,0
1,0,1705,445,19,3.8228699551569507,2150,107.5,0
2,0,1485,230,20,6.428571428571429,1715,81.66666666666667,0
2,1,268,1004,28,0.26666666666666666,1272,43.86206896551724,0
1,2,164,170,11,0.9590643274853801,334,27.833333333333332,0
1,2,493,802,9,0.613947696139477,1295,129.5,0
2,1,2147,450,19,4.760532150776053,2597,129.85,1
1,2,95,307,32,0.30844155844155846,402,12.181818181818182,0
1,0,782,2334,1,0.3349036402569593,3116,1558.0,0
1,3,93,313,10,0.2961783439490446,406,36.90909090909091,0
0,0,635,341,46,1.8567251461988303,976,20.76595744680851,0
1,0,135,1636,19,0.0824679291386683,1771,88.55,0
0,3,83,110,90,0.7477477477477478,193,2.120879120879121,0
1,1,211,91,60,2.2934782608695654,302,4.950819672131147,0
2,0,294,265,12,1.105263157894737,559,43.0,0
0,0,323,716,38,0.4504881450488145,1039,26.641025641025642,0
0,1,1036,387,9,2.670103092783505,1423,142.3,0
1,0,56,750,5,0.07456724367509987,806,134.33333333333334,0
1,0,84,139,63,0.6,223,3.484375,0
0,2,209,242,12,0.8600823045267489,451,34.69230769230769,0
2,1,2056,666,6,3.082458770614693,2722,388.85714285714283,0
2,0,990,195,100,5.051020408163265,1185,11.732673267326733,1
1,0,1310,439,0,2.977272727272727,1749,1749.0,0
2,3,462,680,13,0.6784140969162996,1142,81.57142857142857,0
2,3,239,2909,1,0.08213058419243986,3148,1574.0,0
1,3,38,66,21,0.5671641791044776,104,4.7272727272727275,0
2,0,670,493,15,1.3562753036437247,1163,72.6875,0
1,0,853,403,38,2.1113861386138613,1256,32.205128205128204,0
0,3,2273,1390,92,1.6340762041696621,3663,39.38709677419355,0
1,2,2137,1844,21,1.1582655826558266,3981,180.95454545454547,0
0,2,552,1900,10,0.29037348763808524,2452,222.9090909090909,0
0,2,550,376,61,1.4588859416445623,926,14.935483870967742,0
2,2,175,290,27,0.6013745704467354,465,16.607142857142858,0
2,1,297,477,24,0.6213389121338913,774,30.96,0
2,3,2599,337,6,7.689349112426036,2936,419.42857142857144,1
1,0,152,1015,1,0.14960629921259844,1167,583.5,0
2,3,3464,192,18,17.94818652849741,3656,192.42105263157896,0
0,2,702,859,22,0.8162790697674419,1561,67.8695652173913,0
2,0,609,2093,4,0.29083094555873923,2702,540.4,0
2,1,191,262,1,0.7262357414448669,453,226.5,0
1,3,1083,903,7,1.198008849557522,1986,248.25,0
1,0,615,123,1,4.959677419354839,738,369.0,1
0,0,463,103,1,4.451923076923077,566,283.0,0
1,2,307,98,17,3.101010101010101,405,22.5,1
2,2,68,119,49,0.5666666666666667,187,3.74,0
1,3,732,194,32,3.753846153846154,926,28.060606060606062,0
0,1,375,661,34,0.5664652567975831,1036,29.6,0
2,0,1230,1165,9,1.0548885077186965,2395,239.5,0
0,2,1285,108,0,11.788990825688073,1393,1393.0,0
1,3,403,1632,17,0.2467850581751378,2035,113.05555555555556,0
1,2,1106,1479,14,0.7472972972972973,2585,172.33333333333334,0
0,3,299,1039,88,0.2875,1338,15.03370786516854,0
2,2,1298,444,2,2.9168539325842695,1742,580.6666666666666,0
1,1,16,1,44,8.0,17,0.37777777777777777,1
1,0,164,1061,14,0.1544256120527307,1225,81.66666666666667,0
2,2,281,1689,53,0.16627218934911242,1970,36.48148148148148,0
1,0,1482,326,20,4.532110091743119,1808,86.0952380952381,0
0,3,68,1012,51,0.06712734452122408,1080,20.76923076923077,0
1,1,208,51,18,4.0,259,13.631578947368421,0
1,0,444,988,15,0.448938321536906,1432,89.5,0
2,2,9,56,99,0.15789473684210525,65,0.65,0
0,0,1435,707,13,2.0268361581920904,2142,153.0,0
2,0,821,728,49,1.1262002743484225,1549,30.98,0
1,3,2309,287,2,8.01736111111111,2596,865.3333333333334,0
1,1,31,65,1,0.4696969696969697,96,48.0,0
2,1,316,2386,17,0.13238374528697108,2702,150.11111111111111,0
2,0,1313,613,26,2.1384364820846904,1926,71.33333333333333,0
2,0,1124,693,28,1.6195965417867435,1817,62.6551724137931,0
0,3,278,763,1,0.36387434554973824,1041,520.5,0
1,0,905,1773,35,0.5101465614430665,2678,74.38888888888889,0
2,3,1578,49,4,31.56,1627,325.4,0
1,1,33,1790,93,0.018425460636515914,1823,19.393617021276597,0
0,1,1264,219,12,5.745454545454545,1483,114.07692307692308,0
0,3,290,64,9,4.461538461538462,354,35.4,0
0,0,2953,856,10,3.4457409568261377,3809,346.27272727272725,1
0,1,772,3016,83,0.25588332780908185,3788,45.095238095238095,0
1,2,33,47,19,0.6875,80,4.0,0
0,3,516,444,17,1.1595505617977528,960,53.333333333333336,0
0,1,3390,603,25,5.612582781456954,3993,153.57692307692307,1
2,1,1310,232,80,5.622317596566524,1542,19.037037037037038,1
0,1,357,3253,11,0.10971112476951445,3610,300.8333333333333,0
2,2,856,819,5,1.0439024390243903,1675,279.1666666666667,0
0,2,914,1488,27,0.6138347884486233,2402,85.78571428571429,0
0,2,23,429,20,0.053488372093023255,452,21.523809523809526,0
2,0,197,349,1,0.5628571428571428,546,273.0,0
0,3,802,644,22,1.2434108527131782,1446,62.869565217391305,0
1,0,515,457,24,1.1244541484716157,972,38.88,0
1,2,210,1004,35,0.208955223880597,1214,33.72222222222222,0
0,3,1481,247,162,5.971774193548387,1728,10.60122699386503,1
1,0,671,477,16,1.403765690376569,1148,67.52941176470588,0
2,0,371,1804,21,0.20554016620498616,2175,98.86363636363636,0
0,0,176,1128,2,0.15589016829052257,1304,434.6666666666667,0
0,2,944,147,53,6.378378378378378,1091,20.203703703703702,0
2,1,1097,1743,3,0.6290137614678899,2840,710.0,0
2,3,1107,711,81,1.5547752808988764,1818,22.170731707317074,0
2,2,248,909,12,0.2725274725274725,1157,89.0,0
0,3,904,278,12,3.240143369175627,1182,90.92307692307692,1
2,2,2358,466,11,5.049250535331906,2824,235.33333333333334,0
2,0,435,1315,90,0.3305471124620061,1750,19.23076923076923,0
1,0,236,321,117,0.7329192546583851,557,4.720338983050848,0
1,1,1479,144,108,10.2,1623,14.889908256880734,0
0,1,194,380,36,0.5091863517060368,574,15.513513513513514,0
1,3,292,57,3,5.0344827586206895,349,87.25,0
1,1,106,1012,14,0.10463968410661402,1118,74.53333333333333,0
2,1,311,127,10,2.4296875,438,39.81818181818182,0
2,3,528,268,36,1.962825278810409,796,21.513513513513512,0
1,2,66,1703,20,0.03873239436619718,1769,84.23809523809524,0
1,1,2053,622,28,3.2953451043338684,2675,92.24137931034483,0
1,2,720,310,0,2.315112540192926,1030,1030.0,0
0,0,886,634,45,1.395275590551181,1520,33.04347826086956,0
0,1,464,197,91,2.3434343434343434,661,7.184782608695652,0
0,0,1108,20,33,52.76190476190476,1128,33.1764705882353,0
1,0,565,740,57,0.7624831309041835,1305,22.5,0
1,2,1432,1001,19,1.4291417165668663,2433,121.65,0
0,3,1722,1694,0,1.015929203539823,3416,3416.0,0
0,1,1114,1182,139,0.9416737109044802,2296,16.4,0
1,2,675,2090,1,0.32281205164992827,2765,1382.5,0
2,3,1524,3412,6,0.4465279812481688,4936,705.1428571428571,0
0,0,681,1092,1,0.6230558096980787,1773,886.5,0
1,1,118,1619,29,0.0728395061728395,1737,57.9,0
1,0,123,896,26,0.13712374581939799,1019,37.74074074074074,0
2,0,2967,149,7,19.78,3116,389.5,1
1,1,240,160,94,1.4906832298136645,400,4.2105263157894735,0
1,3,1692,93,73,18.0,1785,24.12162162162162,0
0,3,283,2291,9,0.12347294938917976,2574,257.4,0
0,1,563,893,32,0.6297539149888143,1456,44.121212121212125,0
2,1,1064,1248,57,0.8518815052041633,2312,39.86206896551724,0
2,2,173,321,13,0.5372670807453416,494,35.285714285714285,0
1,2,1336,493,8,2.7044534412955468,1829,203.22222222222223,0
0,0,1170,32,8,35.45454545454545,1202,133.55555555555554,0
2,1,783,1758,51,0.4451392836839113,2541,48.86538461538461,0
2,3,834,1533,18,0.5436766623207301,2367,124.57894736842105,0
2,0,111,1228,37,0.09031733116354759,1339,35.23684210526316,0
1,0,572,48,31,11.673469387755102,620,19.375,1
0,0,90,153,10,0.5844155844155844,243,22.09090909090909,0
2,0,367,325,6,1.1257668711656441,692,98.85714285714286,0
0,3,2305,244,4,9.408163265306122,2549,509.8,0
2,0,854,1458,0,0.5853324194653873,2312,2312.0,0
2,1,1357,173,2,7.7988505747126435,1530,510.0,0
0,2,853,607,8,1.4029605263157894,1460,162.22222222222223,0
0,3,215,677,37,0.31710914454277284,892,23.473684210526315,0
0,1,903,442,5,2.038374717832957,1345,224.16666666666666,0
1,1,1408,220,22,6.3710407239819,1628,70.78260869565217,0
2,1,148,2581,8,0.05731990704879938,2729,303.22222222222223,0
1,2,1697,426,21,3.9742388758782203,2123,96.5,1
0,2,810,1039,41,0.7788461538461539,1849,44.023809523809526,0
2,2,4,162,9,0.024539877300613498,166,16.6,0
1,1,733,1384,12,0.5292418772563177,2117,162.84615384615384,0
2,2,503,194,38,2.5794871794871796,697,17.871794871794872,0
1,0,351,899,23,0.39,1250,52.083333333333336,0
0,2,1475,564,2,2.6106194690265485,2039,679.6666666666666,0
1,3,2297,126,42,18.086614173228348,2423,56.348837209302324,0
2,1,1438,20,9,68.47619047619048,1458,145.8,0
2,1,1875,2136,14,0.8773982218062705,4011,267.4,0
2,0,2394,107,8,22.166666666666668,2501,277.8888888888889,0
2,2,2437,976,23,2.4943705220061414,3413,142.20833333333334,0
0,2,121,846,36,0.14285714285714285,967,26.135135135135137,0
1,3,609,334,48,1.817910447761194,943,19.244897959183675,0
0,0,0,164,76,0.0,164,2.1298701298701297,0
0,3,706,157,13,4.468354430379747,863,61.642857142857146,0
0,3,2580,704,80,3.6595744680851063,3284,40.54320987654321,0
2,1,222,633,28,0.3501577287066246,855,29.482758620689655,0
2,1,1021,1669,14,0.611377245508982,2690,179.33333333333334,0
2,2,1033,817,65,1.2628361858190709,1850,28.03030303030303,0
1,2,174,1368,25,0.127100073046019,1542,59.30769230769231,0
2,3,272,26,18,10.074074074074074,298,15.68421052631579,0
1,2,619,889,0,0.6955056179775281,1508,1508.0,0
2,3,208,212,37,0.9765258215962441,420,11.052631578947368,0
2,2,879,233,2,3.7564102564102564,1112,370.6666666666667,1
0,2,662,1020,10,0.6483839373163565,1682,152.9090909090909,0
0,1,732,1261,97,0.5800316957210776,1993,20.336734693877553,0
0,1,144,371,5,0.3870967741935484,515,85.83333333333333,0
1,1,728,1248,11,0.5828662930344275,1976,164.66666666666666,0
1,1,50,469,80,0.10638297872340426,519,6.407407407407407,0
2,0,2133,1559,12,1.3673076923076923,3692,284.0,0
1,1,420,20,11,20.0,440,36.666666666666664,0
2,0,1940,69,31,27.714285714285715,2009,62.78125,0
1,1,1209,1198,4,1.0083402835696413,2407,481.4,0
1,2,1453,782,108,1.855683269476373,2235,20.504587155963304,0
1,3,377,655,9,0.5746951219512195,1032,103.2,0
0,2,258,761,46,0.33858267716535434,1019,21.680851063829788,0
1,2,522,2129,10,0.24507042253521127,2651,241.0,0
0,0,24,852,9,0.02813599062133646,876,87.6,0
0,1,2510,834,1,3.0059880239520957,3344,1672.0,1
1,3,489,1139,3,0.42894736842105263,1628,407.0,0
2,3,4470,1611,22,2.772952853598015,6081,264.39130434782606,1
2,1,1433,242,25,5.897119341563786,1675,64.42307692307692,1
2,0,83,767,50,0.10807291666666667,850,16.666666666666668,0
1,0,1079,701,1,1.537037037037037,1780,890.0,0
2,0,315,115,13,2.7155172413793105,430,30.714285714285715,0
0,3,279,587,6,0.4744897959183674,866,123.71428571428571,0
2,0,296,57,13,5.103448275862069,353,25.214285714285715,0
1,0,2477,163,13,15.103658536585366,2640,188.57142857142858,0
2,3,693,1953,13,0.3546571136131013,2646,189.0,0
0,3,1107,101,11,10.852941176470589,1208,100.66666666666667,0
1,2,329,691,43,0.4754335260115607,1020,23.181818181818183,0
2,3,740,312,35,2.364217252396166,1052,29.22222222222222,0
1,1,430,648,12,0.662557781201849,1078,82.92307692307692,0
1,3,387,214,4,1.8,601,120.2,0
1,3,283,470,21,0.6008492569002123,753,34.22727272727273,0
2,0,525,1615,75,0.3248762376237624,2140,28.157894736842106,0
1,2,1078,377,3,2.8518518518518516,1455,363.75,0
2,0,251,348,41,0.7191977077363897,599,14.261904761904763,0
0,2,3365,472,27,7.114164904862579,3837,137.03571428571428,1
2,0,133,84,26,1.5647058823529412,217,8.037037037037036,0
0,1,654,391,81,1.6683673469387754,1045,12.74390243902439,0
2,0,88,5,93,14.666666666666666,93,0.9893617021276596,0
1,0,22,559,8,0.039285714285714285,581,64.55555555555556,0
2,1,2559,1506,49,1.6980756469807565,4065,81.3,0
1,1,1662,642,29,2.5847589424572317,2304,76.8,0
0,3,1184,748,15,1.5807743658210949,1932,120.75,0
2,0,2003,24,32,80.12,2027,61.42424242424242,0
1,1,1623,1570,93,1.0330999363462763,3193,33.96808510638298,0
0,1,1041,388,21,2.6760925449871467,1429,64.95454545454545,0
0,3,1879,2946,84,0.6375975568374618,4825,56.76470588235294,1
2,2,495,102,30,4.805825242718447,597,19.258064516129032,1
0,1,804,2315,19,0.3471502590673575,3119,155.95,0
1,1,1497,804,30,1.8596273291925465,2301,74.2258064516129,0
0,0,88,43,27,2.0,131,4.678571428571429,0
0,3,1956,2851,16,0.6858345021037868,4807,282.7647058823529,0
1,0,170,11,24,14.166666666666666,181,7.24,0
0,2,1999,1049,36,1.9038095238095238,3048,82.37837837837837,0
0,3,372,1762,54,0.21100397050482134,2134,38.8,0
0,0,395,154,10,2.5483870967741935,549,49.90909090909091,0
0,1,76,336,0,0.22551928783382788,412,412.0,0
1,1,2170,659,24,3.287878787878788,2829,113.16,1
0,3,191,911,20,0.20942982456140352,1102,52.476190476190474,0
1,1,994,1643,1,0.6046228710462287,2637,1318.5,0
0,0,1032,1145,30,0.900523560209424,2177,70.2258064516129,0
0,3,330,361,85,0.9116022099447514,691,8.034883720930232,0
0,1,4244,1379,15,3.07536231884058,5623,351.4375,1
0,1,66,2706,67,0.024381233838197267,2772,40.76470588235294,0
1,2,936,205,50,4.543689320388349,1141,22.372549019607842,0
1,2,653,61,5,10.53225806451613,714,119.0,0
1,3,281,444,46,0.6314606741573033,725,15.425531914893616,0
2,2,178,1705,21,0.10433763188745604,1883,85.5909090909091,0
0,0,1335,130,75,10.19083969465649,1465,19.276315789473685,1
0,1,2480,1735,6,1.4285714285714286,4215,602.1428571428571,0
1,1,113,3884,4,0.029086229086229085,3997,799.4,0
2,1,215,44,8,4.777777777777778,259,28.77777777777778,0
0,3,4288,546,1,7.839122486288848,4834,2417.0,1
1,3,15,319,11,0.046875,334,27.833333333333332,0
0,2,709,400,9,1.768079800498753,1109,110.9,0
0,1,725,480,16,1.5072765072765073,1205,70.88235294117646,0
1,1,305,1076,18,0.28319405756731664,1381,72.6842105263158,0
1,1,1087,715,4,1.5181564245810055,1802,360.4,0
0,1,2899,2599,28,1.115,5498,189.58620689655172,0
0,1,598,323,7,1.845679012345679,921,115.125,0
1,0,1383,623,3,2.2163461538461537,2006,501.5,0
0,1,1038,1342,37,0.7728965003723008,2380,62.63157894736842,0
0,0,640,373,0,1.7112299465240641,1013,1013.0,0
1,1,51,500,13,0.10179640718562874,551,39.357142857142854,0
0,3,1353,924,4,1.4627027027027026,2277,455.4,0
0,3,451,1577,64,0.2858048162230672,2028,31.2,0
2,0,254,429,52,0.5906976744186047,683,12.88679245283019,0
1,1,2961,607,1,4.870065789473684,3568,1784.0,0
2,3,1485,2955,23,0.5023680649526387,4440,185.0,0
2,3,3277,34,10,93.62857142857143,3311,301.0,1
2,1,296,475,6,0.6218487394957983,771,110.14285714285714,0
0,1,1806,808,11,2.2323856613102597,2614,217.83333333333334,0
0,3,935,6,50,133.57142857142858,941,18.45098039215686,0
2,1,3990,726,1,5.488308115543329,4716,2358.0,1
2,2,2924,46,31,62.212765957446805,2970,92.8125,0
2,1,3610,1559,73,2.3141025641025643,5169,69.85135135135135,0
0,3,3031,1316,17,2.301442672741078,4347,241.5,1
2,3,7,26,69,0.25925925925925924,33,0.4714285714285714,0
2,0,1351,40,71,32.951219512195124,1391,19.319444444444443,1
1,2,317,1120,28,0.28278322925958965,1437,49.55172413793103,0
1,3,1220,369,18,3.2972972972972974,1589,83.63157894736842,0
0,2,3943,684,40,5.7562043795620434,4627,112.85365853658537,1
1,1,40,252,74,0.15810276679841898,292,3.8933333333333335,0
1,3,836,151,34,5.5,987,28.2,1
1,0,1327,280,7,4.722419928825623,1607,200.875,0
0,3,292,226,51,1.2863436123348018,518,9.961538461538462,0
1,0,255,475,90,0.5357142857142857,730,8.021978021978022,0
0,2,62,1098,15,0.056414922656960874,1160,72.5,0
2,0,98,646,35,0.15146831530139104,744,20.666666666666668,0
1,1,1069,751,21,1.4215425531914894,1820,82.72727272727273,0
0,1,703,508,3,1.381139489194499,1211,302.75,0
1,1,30,314,12,0.09523809523809523,344,26.46153846153846,0
2,3,3495,123,5,28.18548387096774,3618,603.0,0
0,1,1067,350,33,3.03988603988604,1417,41.6764705882353,0
0,1,724,875,26,0.8264840182648402,1599,59.22222222222222,0
0,3,318,1058,1,0.3002832861189802,1376,688.0,0
2,2,1073,506,1,2.116370808678501,1579,789.5,0
2,1,452,828,9,0.5452352231604343,1280,128.0,0
2,1,1212,189,40,6.378947368421053,1401,34.170731707317074,1
0,3,1147,1573,4,0.7287166454891995,2720,544.0,0
2,2,97,1607,6,0.06032338308457712,1704,243.42857142857142,0
1,2,2399,308,71,7.763754045307444,2707,37.59722222222222,1
2,2,667,634,23,1.0503937007874016,1301,54.208333333333336,0
0,3,499,746,29,0.6680053547523427,1245,41.5,0
1,0,3111,511,18,6.076171875,3622,190.6315789473684,0
2,0,576,1936,10,0.2973670624677336,2512,228.36363636363637,0
1,1,1277,1076,8,1.1857010213556174,2353,261.44444444444446,0
1,1,1064,893,26,1.1901565995525727,1957,72.48148148148148,0
0,1,180,587,19,0.30612244897959184,767,38.35,0
1,0,4726,70,15,66.56338028169014,4796,299.75,1
1,3,622,91,35,6.760869565217392,713,19.805555555555557,0
0,1,502,284,15,1.7614035087719297,786,49.125,0
0,3,2520,190,1,13.193717277486911,2710,1355.0,0
0,1,753,2438,54,0.3087330873308733,3191,58.018181818181816,0
1,3,1221,421,11,2.8933649289099526,1642,136.83333333333334,0
1,3,1872,1673,87,1.118279569892473,3545,40.28409090909091,0
1,0,268,1363,63,0.19648093841642228,1631,25.484375,0
0,3,185,1339,7,0.13805970149253732,1524,190.5,0
2,2,70,194,100,0.358974358974359,264,2.613861386138614,0
1,0,2274,474,57,4.787368421052632,2748,47.37931034482759,0
2,1,223,306,126,0.7263843648208469,529,4.165354330708661,0
0,0,367,2816,33,0.13028044018459353,3183,93.61764705882354,0
1,2,336,1674,80,0.20059701492537313,2010,24.814814814814813,0
2,2,363,230,35,1.5714285714285714,593,16.47222222222222,0
1,3,1102,300,57,3.661129568106312,1402,24.17241379310345,0
1,2,3081,602,28,5.109452736318408,3683,127.0,1
1,2,399,261,79,1.5229007633587786,660,8.25,0
2,2,523,1392,21,0.375448671931084,1915,87.04545454545455,0
0,2,1474,1368,40,1.0766983199415632,2842,69.3170731707317,0
1,1,566,1030,74,0.5489815712900097,1596,21.28,0
0,1,2604,935,16,2.782051282051282,3539,208.1764705882353,0
0,0,699,634,0,1.1007874015748031,1333,1333.0,0
2,3,427,341,3,1.2485380116959064,768,192.0,0
2,1,3560,1450,107,2.4534803583735356,5010,46.388888888888886,1
0,2,554,1566,61,0.35354179961710275,2120,34.193548387096776,0
1,3,262,40,19,6.390243902439025,302,15.1,0
2,1,195,406,97,0.47911547911547914,601,6.13265306122449,0
1,0,5335,21,6,242.5,5356,765.1428571428571,1
1,2,1398,1463,3,0.9549180327868853,2861,715.25,0
1,3,525,155,27,3.3653846153846154,680,24.285714285714285,0
0,1,1750,896,14,1.9509476031215163,2646,176.4,0
1,3,791,353,12,2.2344632768361583,1144,88.0,0
0,1,381,1354,39,0.2811808118081181,1735,43.375,0
0,0,1360,570,4,2.3817863397548162,1930,386.0,0
1,2,1370,313,45,4.3630573248407645,1683,36.58695652173913,0
1,0,693,313,13,2.2070063694267517,1006,71.85714285714286,0
1,2,46,316,129,0.14511041009463724,362,2.7846153846153845,0
1,2,80,1243,49,0.06430868167202572,1323,26.46,0
0,3,1554,993,31,1.5633802816901408,2547,79.59375,0
1,1,1734,307,7,5.62987012987013,2041,255.125,0
1,0,1134,539,93,2.1,1673,17.79787234042553,0
0,0,1826,63,1,28.53125,1889,944.5,1
2,0,1271,1405,7,0.9039829302987198,2676,334.5,0
2,3,2272,247,1,9.161290322580646,2519,1259.5,1
0,3,162,1760,101,0.0919931856899489,1922,18.84313725490196,0
2,3,490,726,61,0.6740027510316369,1216,19.612903225806452,0
0,2,623,671,91,0.9270833333333334,1294,14.065217391304348,0
1,0,353,142,37,2.4685314685314683,495,13.026315789473685,0
1,2,1292,57,0,22.275862068965516,1349,1349.0,1
2,0,2435,643,80,3.781055900621118,3078,38.0,0
1,0,531,504,16,1.0514851485148515,1035,60.88235294117647,0
2,1,2839,101,13,27.833333333333332,2940,210.0,0
2,0,727,1444,10,0.5031141868512111,2171,197.36363636363637,0
1,3,739,431,10,1.7106481481481481,1170,106.36363636363636,0
1,3,916,241,48,3.7851239669421486,1157,23.612244897959183,0
2,3,312,1241,8,0.25120772946859904,1553,172.55555555555554,0
1,1,483,1954,7,0.24705882352941178,2437,304.625,0
0,1,805,292,35,2.7474402730375425,1097,30.47222222222222,0
1,2,2847,1196,10,2.3784461152882206,4043,367.54545454545456,0
1,0,1029,845,0,1.2163120567375887,1874,1874.0,0
0,0,405,3662,80,0.11056511056511056,4067,50.20987654320987,0
1,3,10,182,11,0.0546448087431694,192,16.0,0
1,3,3998,2588,43,1.5442255697180378,6586,149.6818181818182,0
2,3,679,302,18,2.240924092409241,981,51.63157894736842,0
1,3,2788,424,4,6.56,3212,642.4,1
1,3,797,355,32,2.2387640449438204,1152,34.90909090909091,0
0,3,930,250,7,3.7051792828685257,1180,147.5,0
2,0,1244,945,10,1.3150105708245243,2189,199.0,0
2,1,387,711,0,0.5435393258426966,1098,1098.0,0
2,3,1200,291,0,4.109589041095891,1491,1491.0,1
1,0,748,113,21,6.56140350877193,861,39.13636363636363,0
2,3,1116,305,1,3.6470588235294117,1421,710.5,1
0,2,1806,384,7,4.6909090909090905,2190,273.75,1
2,2,203,383,77,0.5286458333333334,586,7.512820512820513,0
0,0,950,353,2,2.6836158192090394,1303,434.3333333333333,0
2,1,53,39,10,1.325,92,8.363636363636363,0
2,2,107,498,38,0.21442885771543085,605,15.512820512820513,0
0,2,1122,1447,64,0.7748618784530387,2569,39.52307692307692,0
2,1,73,159,1,0.45625,232,116.0,0
2,2,904,125,6,7.174603174603175,1029,147.0,0
2,3,248,510,14,0.48532289628180036,758,50.53333333333333,0
1,1,362,370,13,0.9757412398921833,732,52.285714285714285,0
0,2,138,659,10,0.20909090909090908,797,72.45454545454545,0
2,1,285,2351,8,0.1211734693877551,2636,292.8888888888889,0
0,3,1722,1144,9,1.503930131004367,2866,286.6,0
0,2,1018,929,4,1.0946236559139786,1947,389.4,0
0,0,2990,430,5,6.937354988399072,3420,570.0,1
2,2,49,271,28,0.1801470588235294,320,11.03448275862069,0
2,2,1572,621,10,2.527331189710611,2193,199.36363636363637,0
0,3,1200,1733,15,0.6920415224913494,2933,183.3125,0
1,0,302,1674,15,0.18029850746268658,1976,123.5,0
0,0,1306,471,3,2.766949152542373,1777,444.25,0
1,0,1260,226,51,5.5506607929515415,1486,28.576923076923077,0
0,3,614,204,93,2.995121951219512,818,8.702127659574469,0
0,3,1166,27,9,41.642857142857146,1193,119.3,0
0,3,588,1479,10,0.3972972972972973,2067,187.9090909090909,0
2,3,408,246,35,1.6518218623481782,654,18.166666666666668,0
1,3,628,355,2,1.7640449438202248,983,327.6666666666667,0
1,0,2255,1325,71,1.700603318250377,3580,49.72222222222222,0
0,1,485,102,3,4.70873786407767,587,146.75,0
2,3,516,494,39,1.0424242424242425,1010,25.25,0
2,1,937,104,10,8.923809523809524,1041,94.63636363636364,1
1,2,1398,466,11,2.993576017130621,1864,155.33333333333334,0
2,2,1326,38,4,34.0,1364,272.8,0
1,3,19,583,31,0.032534246575342464,602,18.8125,0
1,2,1162,1270,47,0.9142407553107789,2432,50.666666666666664,0
1,1,598,902,90,0.6622369878183831,1500,16.483516483516482,0
2,2,742,569,12,1.3017543859649123,1311,100.84615384615384,0
1,2,824,1411,29,0.5835694050991501,2235,74.5,0
1,1,1315,206,16,6.352657004830918,1521,89.47058823529412,0
0,2,1779,1421,24,1.251054852320675,3200,128.0,0
1,3,1039,258,5,4.011583011583012,1297,216.16666666666666,0
1,1,829,360,26,2.296398891966759,1189,44.03703703703704,0
0,1,468,109,56,4.254545454545455,577,10.12280701754386,0
0,0,148,85,59,1.7209302325581395,233,3.8833333333333333,0
2,0,3183,2151,19,1.479089219330855,5334,266.7,1
1,1,619,168,8,3.662721893491124,787,87.44444444444444,0
2,1,835,324,54,2.5692307692307694,1159,21.072727272727274,0
2,0,1390,602,224,2.3051409618573797,1992,8.853333333333333,0
0,3,70,342,14,0.20408163265306123,412,27.466666666666665,0
2,2,1931,1632,77,1.1824862216778935,3563,45.67948717948718,0
1,2,1594,1847,123,0.8625541125541125,3441,27.75,0
0,2,1489,315,15,4.712025316455696,1804,112.75,0
1,1,22,77,37,0.28205128205128205,99,2.6052631578947367,0
1,3,747,188,26,3.9523809523809526,935,34.629629629629626,0
0,0,55,514,38,0.10679611650485436,569,14.58974358974359,0
1,3,800,272,5,2.93040293040293,1072,178.66666666666666,0
0,3,1267,483,13,2.6177685950413223,1750,125.0,0
1,2,129,1137,1,0.11335676625659051,1266,633.0,0
0,0,1187,436,28,2.7162471395881007,1623,55.96551724137931,0
2,3,596,175,78,3.3863636363636362,771,9.759493670886076,0
1,0,1668,354,24,4.698591549295775,2022,80.88,1
0,1,762,1086,2,0.7010119595216191,1848,616.0,0
1,2,409,441,79,0.9253393665158371,850,10.625,0
1,0,403,229,4,1.7521739130434784,632,126.4,0
1,1,2277,446,64,5.093959731543624,2723,41.89230769230769,1
0,1,603,485,37,1.2407407407407407,1088,28.63157894736842,0
2,1,520,281,30,1.8439716312056738,801,25.838709677419356,0
2,3,40,4356,26,0.009180628873077806,4396,162.8148148148148,0
2,3,453,1167,4,0.3878424657534247,1620,324.0,0
0,2,1894,943,20,2.0063559322033897,2837,135.0952380952381,0
2,2,1431,1544,6,0.9262135922330097,2975,425.0,0
0,1,249,878,25,0.2832764505119454,1127,43.34615384615385,0
1,2,532,1252,17,0.4245810055865922,1784,99.11111111111111,0
1,3,218,425,34,0.5117370892018779,643,18.37142857142857,0
2,2,3083,555,121,5.544964028776978,3638,29.81967213114754,0
0,0,911,38,13,23.358974358974358,949,67.78571428571429,1
1,3,1403,263,28,5.3143939393939394,1666,57.44827586206897,0
0,1,1251,367,59,3.3994565217391304,1618,26.966666666666665,0
0,1,2069,785,2,2.632315521628499,2854,951.3333333333334,0
1,2,2982,499,48,5.964,3481,71.04081632653062,0
0,3,32,748,8,0.042723631508678236,780,86.66666666666667,0
1,1,3700,999,23,3.7,4699,195.79166666666666,1
1,1,2044,34,143,58.4,2078,14.430555555555555,0
1,3,482,239,124,2.0083333333333333,721,5.768,0
0,3,1814,149,11,12.093333333333334,1963,163.58333333333334,0
1,1,1333,166,4,7.982035928143713,1499,299.8,0
0,2,1575,559,83,2.8125,2134,25.404761904761905,0
1,2,249,1077,67,0.23098330241187384,1326,19.5,0
1,2,1045,254,28,4.098039215686274,1299,44.793103448275865,0
2,0,26,1391,0,0.01867816091954023,1417,1417.0,0
2,3,1885,1783,41,1.0566143497757847,3668,87.33333333333333,0
2,1,3016,345,5,8.716763005780347,3361,560.1666666666666,1
0,0,1085,914,85,1.185792349726776,1999,23.24418604651163,0
0,2,718,99,17,7.18,817,45.388888888888886,0
1,0,1293,1090,28,1.1851512373968836,2383,82.17241379310344,0
1,1,395,144,9,2.7241379310344827,539,53.9,0
1,1,984,930,19,1.0569280343716434,1914,95.7,0
1,3,1269,438,42,2.8906605922551254,1707,39.69767441860465,0
0,2,153,2109,20,0.07251184834123223,2262,107.71428571428571,0
1,2,150,499,56,0.3,649,11.385964912280702,0
1,0,1259,25,37,48.42307692307692,1284,33.78947368421053,0
2,2,565,524,2,1.0761904761904761,1089,363.0,0
1,0,2200,1269,28,1.7322834645669292,3469,119.62068965517241,0
1,1,373,833,28,0.447242206235012,1206,41.58620689655172,0
1,1,43,2712,14,0.0158496129745669,2755,183.66666666666666,0
0,1,1049,1482,11,0.7073499662845584,2531,210.91666666666666,0
2,1,1152,598,1,1.9232053422370619,1750,875.0,0
1,1,806,185,17,4.333333333333333,991,55.05555555555556,0
1,0,1149,3,12,287.25,1152,88.61538461538461,0
2,1,741,3149,90,0.23523809523809525,3890,42.747252747252745,0
1,0,1179,2228,33,0.5289367429340511,3407,100.20588235294117,0
0,1,44,256,18,0.17120622568093385,300,15.789473684210526,0
1,0,459,813,42,0.5638820638820639,1272,29.58139534883721,0
0,0,236,1045,45,0.22562141491395793,1281,27.847826086956523,0
0,0,104,690,19,0.15050651230101303,794,39.7,0
1,2,266,1481,2,0.1794871794871795,1747,582.3333333333334,0
2,0,212,64,45,3.2615384615384615,276,6.0,1
0,0,3616,1814,2,1.9922865013774105,5430,1810.0,0
2,1,337,398,56,0.8446115288220551,735,12.894736842105264,0
1,0,262,524,12,0.4990476190476191,786,60.46153846153846,0
0,0,1801,470,30,3.8237791932059446,2271,73.25806451612904,0
1,3,543,606,40,0.8945634266886326,1149,28.024390243902438,0
2,2,547,729,1,0.7493150684931507,1276,638.0,0
1,3,586,991,14,0.5907258064516129,1577,105.13333333333334,0
1,1,538,595,27,0.9026845637583892,1133,40.464285714285715,0
0,2,395,923,56,0.4274891774891775,1318,23.12280701754386,0
1,2,337,330,37,1.0181268882175227,667,17.55263157894737,0
1,3,2136,2207,67,0.967391304347826,4343,63.86764705882353,0
1,2,176,53,2,3.259259259259259,229,76.33333333333333,0
0,3,199,630,2,0.3153724247226624,829,276.3333333333333,0
2,0,847,73,37,11.445945945945946,920,24.210526315789473,0
2,3,421,467,15,0.8995726495726496,888,55.5,0
1,2,547,238,19,2.288702928870293,785,39.25,0
0,2,1642,2210,27,0.7426503844414292,3852,137.57142857142858,0
1,1,2339,10,127,212.63636363636363,2349,18.3515625,0
2,1,1563,397,2,3.9271356783919598,1960,653.3333333333334,0
0,1,267,1218,3,0.21903199343724364,1485,371.25,0
2,1,3910,167,53,23.273809523809526,4077,75.5,0
2,2,451,1352,0,0.3333333333333333,1803,1803.0,0
0,1,185,1571,17,0.11768447837150127,1756,97.55555555555556,0
0,3,692,984,44,0.7025380710659899,1676,37.24444444444445,0
1,0,1292,187,6,6.872340425531915,1479,211.28571428571428,1
1,2,86,254,6,0.33725490196078434,340,48.57142857142857,0
2,1,1005,146,11,6.836734693877551,1151,95.91666666666667,0
0,2,1952,162,4,11.975460122699387,2114,422.8,0
0,1,303,29,34,10.1,332,9.485714285714286,0
1,2,1181,1557,6,0.7580231065468549,2738,391.14285714285717,0
2,1,510,601,7,0.8471760797342193,1111,138.875,0
2,0,534,317,25,1.679245283018868,851,32.73076923076923,0
1,1,329,273,102,1.2007299270072993,602,5.844660194174757,0
0,3,979,629,73,1.553968253968254,1608,21.72972972972973,0
1,2,447,316,59,1.4100946372239747,763,12.716666666666667,0
1,2,1777,1594,22,1.1141065830721004,3371,146.56521739130434,0
1,3,3294,189,10,17.33684210526316,3483,316.6363636363636,0
1,3,2734,1711,36,1.59696261682243,4445,120.13513513513513,0
0,0,178,872,14,0.20389461626575028,1050,70.0,0
1,2,14,2510,45,0.005575467941059339,2524,54.869565217391305,0
0,0,577,12,0,44.38461538461539,589,589.0,0
1,2,1305,48,22,26.632653061224488,1353,58.82608695652174,0
2,2,3792,555,12,6.820143884892087,4347,334.38461538461536,1
0,0,1529,1947,8,0.7849075975359343,3476,386.22222222222223,0
2,2,868,1049,32,0.8266666666666667,1917,58.09090909090909,0
1,2,26,778,32,0.03337612323491656,804,24.363636363636363,0
1,0,1746,25,1,67.15384615384616,1771,885.5,1
1,1,194,349,88,0.5542857142857143,543,6.101123595505618,0
0,0,57,339,13,0.1676470588235294,396,28.285714285714285,0
2,2,1899,624,74,3.0384,2523,33.64,0
0,3,835,238,26,3.493723849372385,1073,39.74074074074074,0
0,1,137,248,31,0.5502008032128514,385,12.03125,0
1,3,488,775,96,0.6288659793814433,1263,13.02061855670103,0
2,1,89,2314,51,0.03844492440604751,2403,46.21153846153846,0
1,3,1016,863,4,1.1759259259259258,1879,375.8,0
0,1,331,882,0,0.37485843714609285,1213,1213.0,0
1,0,2010,3427,11,0.5863477246207701,5437,453.0833333333333,1
2,1,442,133,20,3.298507462686567,575,27.38095238095238,0
1,1,682,27,39,24.357142857142858,709,17.725,1
2,1,65,1094,32,0.0593607305936073,1159,35.121212121212125,0
2,2,322,462,11,0.6954643628509719,784,65.33333333333333,0
1,3,1129,448,23,2.514476614699332,1577,65.70833333333333,0
0,0,1332,204,31,6.4975609756097565,1536,48.0,1
1,3,278,565,21,0.4911660777385159,843,38.31818181818182,0
0,3,700,466,35,1.4989293361884368,1166,32.388888888888886,0
0,0,1701,339,19,5.002941176470588,2040,102.0,0
1,2,477,467,22,1.0192307692307692,944,41.04347826086956,0
0,1,143,387,84,0.36855670103092786,530,6.235294117647059,0
0,2,565,2249,14,0.2511111111111111,2814,187.6,0
1,2,917,3139,42,0.29203821656050954,4056,94.32558139534883,0
1,1,7,1465,12,0.0047748976807639835,1472,113.23076923076923,0
1,3,428,3717,12,0.11511565357719204,4145,318.84615384615387,0
0,1,935,247,78,3.7701612903225805,1182,14.962025316455696,1
2,0,3034,1480,35,2.048615800135044,4514,125.38888888888889,0
0,1,525,417,79,1.255980861244019,942,11.775,0
2,3,177,1096,156,0.16134913400182316,1273,8.10828025477707,0
1,2,764,179,0,4.2444444444444445,943,943.0,1
2,2,336,1336,122,0.2513089005235602,1672,13.59349593495935,0
1,1,241,69,3,3.442857142857143,310,77.5,1
1,0,892,252,2,3.525691699604743,1144,381.3333333333333,0
2,3,2475,1380,43,1.7921795800144822,3855,87.61363636363636,0
1,2,1803,1099,12,1.6390909090909092,2902,223.23076923076923,0
2,1,201,556,74,0.3608617594254937,757,10.093333333333334,0
1,0,1451,893,23,1.6230425055928412,2344,97.66666666666667,0
0,0,261,164,14,1.5818181818181818,425,28.333333333333332,0
0,2,343,881,2,0.3888888888888889,1224,408.0,0
1,2,2526,6,18,360.85714285714283,2532,133.26315789473685,0
1,3,2419,1432,9,1.6880669923237963,3851,385.1,0
2,0,184,581,2,0.3161512027491409,765,255.0,0
0,3,66,2304,33,0.02863340563991323,2370,69.70588235294117,0
2,0,346,520,113,0.6641074856046065,866,7.5964912280701755,0
1,0,871,454,14,1.9142857142857144,1325,88.33333333333333,0
1,1,2094,478,10,4.37160751565762,2572,233.8181818181818,1
2,2,126,356,2,0.35294117647058826,482,160.66666666666666,0
1,0,536,145,7,3.671232876712329,681,85.125,0
0,3,317,1476,10,0.21462423832092078,1793,163.0,0
2,2,15,394,12,0.0379746835443038,409,31.46153846153846,0
0,3,1553,602,30,2.5754560530679935,2155,69.51612903225806,0
0,2,1678,16,3,98.70588235294117,1694,423.5,0
0,2,250,49,1,5.0,299,149.5,0
2,0,163,727,80,0.2239010989010989,890,10.987654320987655,0
1,1,156,1691,48,0.09219858156028368,1847,37.69387755102041,0
0,0,623,544,9,1.1431192660550458,1167,116.7,0
0,2,283,144,30,1.9517241379310344,427,13.774193548387096,0
0,0,716,98,26,7.232323232323233,814,30.14814814814815,0
1,0,485,1840,40,0.2634437805540467,2325,56.707317073170735,0
1,2,236,967,58,0.24380165289256198,1203,20.389830508474578,0
2,2,1391,2709,13,0.5132841328413285,4100,292.85714285714283,0
1,0,162,68,32,2.347826086956522,230,6.96969696969697,0
2,0,1603,1863,48,0.8599785407725322,3466,70.73469387755102,0
2,0,824,1494,36,0.551170568561873,2318,62.648648648648646,0
2,3,1784,1789,76,0.9966480446927374,3573,46.4025974025974,0
2,0,4,4,20,0.8,8,0.38095238095238093,0
2,3,1383,1083,48,1.2758302583025831,2466,50.326530612244895,0
0,1,52,636,72,0.08163265306122448,688,9.424657534246576,0
1,3,2997,681,24,4.394428152492669,3678,147.12,0
0,0,1213,506,0,2.3925049309664694,1719,1719.0,0
2,1,385,1085,51,0.35451197053406996,1470,28.26923076923077,0
1,3,385,6988,56,0.05508656460151667,7373,129.35087719298247,0
0,3,1976,991,15,1.9919354838709677,2967,185.4375,0
0,2,2331,906,7,2.570011025358324,3237,404.625,0
2,1,2221,850,114,2.609870740305523,3071,26.704347826086956,0
0,2,1654,950,24,1.7392218717139853,2604,104.16,0
0,1,1709,334,21,5.101492537313433,2043,92.86363636363636,0
0,3,850,308,87,2.750809061488673,1158,13.159090909090908,0
0,2,28,1227,15,0.02280130293159609,1255,78.4375,0
0,0,90,43,56,2.0454545454545454,133,2.3333333333333335,0
2,3,1048,1139,36,0.9192982456140351,2187,59.108108108108105,0
2,1,512,1344,102,0.38066914498141263,1856,18.019417475728154,0
0,1,837,589,16,1.4186440677966101,1426,83.88235294117646,0
2,2,262,1927,71,0.1358921161825726,2189,30.40277777777778,0
2,2,1048,512,25,2.042884990253411,1560,60.0,0
1,1,278,156,19,1.7707006369426752,434,21.7,0
0,3,617,358,10,1.7186629526462396,975,88.63636363636364,0
2,2,651,1890,24,0.3442622950819672,2541,101.64,0
2,0,195,4058,25,0.04804138950480414,4253,163.57692307692307,0
0,1,2089,438,68,4.758542141230068,2527,36.6231884057971,0
1,0,746,146,36,5.074829931972789,892,24.10810810810811,0
0,1,2015,269,52,7.462962962962963,2284,43.094339622641506,0
1,0,304,644,43,0.47131782945736433,948,21.545454545454547,0
0,3,189,679,9,0.27794117647058825,868,86.8,0
0,1,18,795,6,0.022613065326633167,813,116.14285714285714,0
0,3,98,1443,8,0.06786703601108034,1541,171.22222222222223,0
0,2,159,993,4,0.15995975855130784,1152,230.4,0
1,1,82,241,14,0.33884297520661155,323,21.533333333333335,0
1,3,2271,402,31,5.635235732009925,2673,83.53125,1
2,0,2424,1465,23,1.6534788540245566,3889,162.04166666666666,0
0,3,2770,802,34,3.4495641344956414,3572,102.05714285714286,0
1,1,3215,145,13,22.02054794520548,3360,240.0,1
1,3,676,315,6,2.1392405063291138,991,141.57142857142858,0
1,0,755,1252,6,0.6025538707102953,2007,286.7142857142857,0
0,0,140,151,27,0.9210526315789473,291,10.392857142857142,0
2,0,147,939,5,0.15638297872340426,1086,181.0,0
1,2,1481,663,15,2.230421686746988,2144,134.0,0
0,1,1936,127,7,15.125,2063,257.875,0
1,0,1535,934,32,1.641711229946524,2469,74.81818181818181,0
1,2,1799,122,28,14.626016260162602,1921,66.24137931034483,1
2,0,323,406,14,0.7936117936117936,729,48.6,0
1,3,627,295,4,2.1182432432432434,922,184.4,0
1,1,614,936,7,0.655282817502668,1550,193.75,0
0,3,5356,1219,19,4.390163934426229,6575,328.75,0
0,2,2979,147,107,20.12837837837838,3126,28.944444444444443,0
2,3,912,1337,9,0.6816143497757847,2249,224.9,0
0,3,148,5,6,24.666666666666668,153,21.857142857142858,1
0,0,299,604,7,0.49421487603305786,903,112.875,0
2,3,452,581,36,0.7766323024054983,1033,27.91891891891892,0
1,0,2065,782,73,2.637292464878672,2847,38.472972972972975,0
2,0,187,219,2,0.85,406,135.33333333333334,0
0,1,248,7,41,31.0,255,6.071428571428571,0
2,2,429,485,20,0.8827160493827161,914,43.523809523809526,0
1,2,2616,59,52,43.6,2675,50.471698113207545,0
2,2,700,1781,16,0.39281705948372614,2481,145.94117647058823,0
0,0,1040,152,0,6.7973856209150325,1192,1192.0,0
0,2,489,443,34,1.1013513513513513,932,26.62857142857143,0
2,0,208,455,49,0.45614035087719296,663,13.26,0
1,1,252,643,69,0.391304347826087,895,12.785714285714286,0
2,2,1622,1220,25,1.3284193284193284,2842,109.3076923076923,0
1,0,2239,511,3,4.373046875,2750,687.5,1
1,2,679,20,13,32.333333333333336,699,49.92857142857143,0
2,2,441,1179,46,0.373728813559322,1620,34.46808510638298,0
1,1,1649,68,20,23.89855072463768,1717,81.76190476190476,0
0,3,1118,820,36,1.3617539585870888,1938,52.37837837837838,0
2,2,41,1301,0,0.0314900153609831,1342,1342.0,0
1,1,431,265,2,1.6203007518796992,696,232.0,0
0,2,1146,476,34,2.40251572327044,1622,46.34285714285714,0
2,2,852,11,10,71.0,863,78.45454545454545,1
0,2,3819,1303,14,2.928680981595092,5122,341.46666666666664,1
0,2,2010,971,30,2.067901234567901,2981,96.16129032258064,0
0,3,61,210,3,0.2890995260663507,271,67.75,0
1,3,1293,395,53,3.265151515151515,1688,31.25925925925926,1
2,2,409,950,4,0.43007360672975814,1359,271.8,0
2,2,1145,354,39,3.2253521126760565,1499,37.475,1
1,1,960,141,10,6.76056338028169,1101,100.0909090909091,0
2,1,699,584,9,1.1948717948717948,1283,128.3,0
0,0,1916,1028,51,1.8620019436345967,2944,56.61538461538461,0
2,3,1233,309,24,3.97741935483871,1542,61.68,1
1,2,2203,103,6,21.182692307692307,2306,329.42857142857144,0
0,3,330,1415,0,0.2330508474576271,1745,1745.0,0
1,1,427,233,108,1.8247863247863247,660,6.055045871559633,0
0,3,972,575,16,1.6875,1547,91.0,0
0,3,3395,940,15,3.607863974495218,4335,270.9375,0
2,2,464,305,1,1.5163398692810457,769,384.5,0
0,2,32,836,67,0.038231780167264036,868,12.764705882352942,0
1,1,590,492,4,1.1967545638945234,1082,216.4,0
2,2,785,675,12,1.1612426035502958,1460,112.3076923076923,0
1,1,1614,714,16,2.257342657342657,2328,136.94117647058823,0
0,1,1304,1390,49,0.9374550682961897,2694,53.88,0
1,0,3342,854,13,3.9087719298245616,4196,299.7142857142857,0
1,0,1526,245,22,6.203252032520325,1771,77.0,1
0,0,354,49,16,7.08,403,23.705882352941178,0
2,3,1025,1,11,512.5,1026,85.5,0
1,0,1115,1878,87,0.5934007450771687,2993,34.01136363636363,0
0,2,6224,2279,47,2.729824561403509,8503,177.14583333333334,1
2,2,149,79,5,1.8625,228,38.0,0
2,0,212,534,24,0.39626168224299063,746,29.84,0
2,3,169,131,47,1.2803030303030303,300,6.25,0
1,1,889,2376,26,0.3740008413967186,3265,120.92592592592592,0
1,3,145,226,20,0.6387665198237885,371,17.666666666666668,0
1,3,1067,557,2,1.9121863799283154,1624,541.3333333333334,0
2,1,1628,144,3,11.227586206896552,1772,443.0,1
1,1,567,323,8,1.75,890,98.88888888888889,0
0,1,822,248,21,3.3012048192771086,1070,48.63636363636363,1
1,2,2438,516,130,4.715667311411992,2954,22.549618320610687,0
1,1,842,435,48,1.9311926605504588,1277,26.06122448979592,0
2,1,233,321,3,0.7236024844720497,554,138.5,0
1,3,420,89,37,4.666666666666667,509,13.394736842105264,0
0,3,754,530,49,1.4199623352165724,1284,25.68,0
2,0,168,1518,16,0.11059907834101383,1686,99.17647058823529,0
0,3,948,1048,12,0.90371782650143,1996,153.53846153846155,0
2,1,7190,1020,26,7.0421155729676785,8210,304.0740740740741,0
2,2,1057,364,21,2.8958904109589043,1421,64.5909090909091,0
1,3,465,985,9,0.4716024340770791,1450,145.0,0
0,3,403,501,15,0.8027888446215139,904,56.5,0
2,1,2682,130,23,20.47328244274809,2812,117.16666666666667,0
1,3,2051,434,26,4.714942528735632,2485,92.03703703703704,0
2,3,639,113,22,5.605263157894737,752,32.69565217391305,1
2,1,436,97,56,4.448979591836735,533,9.350877192982455,0
2,3,1239,18,0,65.21052631578948,1257,1257.0,0
2,2,377,265,12,1.4172932330827068,642,49.38461538461539,0
2,0,127,321,41,0.3944099378881988,448,10.666666666666666,0
2,3,371,961,31,0.38565488565488565,1332,41.625,0
1,2,569,617,75,0.9207119741100324,1186,15.605263157894736,0
2,3,294,1564,26,0.1878594249201278,1858,68.81481481481481,0
0,0,244,155,30,1.564102564102564,399,12.870967741935484,0
1,1,6,247,36,0.024193548387096774,253,6.837837837837838,0
0,0,996,2265,6,0.43954104148278905,3261,465.85714285714283,0
2,3,953,469,41,2.027659574468085,1422,33.857142857142854,0
0,0,208,1244,10,0.1670682730923695,1452,132.0,0
2,0,2876,542,16,5.296500920810313,3418,201.05882352941177,0
2,1,526,509,0,1.031372549019608,1035,1035.0,0
1,3,25,128,55,0.1937984496124031,153,2.732142857142857,0
1,0,248,1524,92,0.16262295081967212,1772,19.053763440860216,0
2,0,1177,65,1,17.833333333333332,1242,621.0,0
1,1,225,297,30,0.7550335570469798,522,16.838709677419356,0
0,2,55,895,97,0.06138392857142857,950,9.693877551020408,0
1,3,961,566,28,1.6948853615520283,1527,52.6551724137931,0
1,2,730,1705,47,0.42790152403282533,2435,50.729166666666664,0
0,2,1432,32,3,43.39393939393939,1464,366.0,0
1,1,1481,838,8,1.765196662693683,2319,257.6666666666667,0
2,1,3217,519,12,6.186538461538461,3736,287.38461538461536,1
0,3,58,134,119,0.42962962962962964,192,1.6,0
2,2,39,1087,45,0.035845588235294115,1126,24.47826086956522,0
0,0,4358,423,65,10.278301886792454,4781,72.43939393939394,1
2,2,1035,606,20,1.7051070840197693,1641,78.14285714285714,0
2,1,1256,2735,37,0.4590643274853801,3991,105.02631578947368,0
1,0,101,532,39,0.1894934333958724,633,15.825,0
2,0,72,1386,25,0.05191059841384282,1458,56.07692307692308,0
1,1,174,1174,63,0.14808510638297873,1348,21.0625,0
0,0,557,869,5,0.6402298850574712,1426,237.66666666666666,0
2,2,116,1816,1,0.06384149697303247,1932,966.0,0
2,1,591,231,10,2.5474137931034484,822,74.72727272727273,0
0,3,824,1375,2,0.5988372093023255,2199,733.0,0
0,1,0,379,1,0.0,379,189.5,0
2,3,121,1339,16,0.09029850746268657,1460,85.88235294117646,0
0,3,470,544,6,0.8623853211009175,1014,144.85714285714286,0
1,1,54,1559,46,0.03461538461538462,1613,34.319148936170215,0
0,1,143,1801,26,0.07935627081021088,1944,72.0,0
0,3,263,728,13,0.3607681755829904,991,70.78571428571429,0
2,3,561,566,10,0.9894179894179894,1127,102.45454545454545,0
1,0,1254,1223,24,1.0245098039215685,2477,99.08,0
0,1,142,248,17,0.570281124497992,390,21.666666666666668,0
1,1,1339,12,1,103.0,1351,675.5,0
1,0,1931,418,32,4.608591885441528,2349,71.18181818181819,0
1,1,1054,567,20,1.8556338028169015,1621,77.19047619047619,0
2,0,44,282,9,0.15547703180212014,326,32.6,0
0,0,580,386,10,1.4987080103359174,966,87.81818181818181,0
2,1,1079,114,18,9.382608695652173,1193,62.78947368421053,1
0,2,3840,259,52,14.76923076923077,4099,77.33962264150944,0
0,3,3032,219,16,13.781818181818181,3251,191.23529411764707,0
2,1,503,286,54,1.7526132404181185,789,14.345454545454546,0
1,2,956,284,16,3.354385964912281,1240,72.94117647058823,0
1,0,2214,654,53,3.380152671755725,2868,53.111111111111114,0
0,2,1778,230,80,7.696969696969697,2008,24.790123456790123,1
2,1,652,2263,0,0.2879858657243816,2915,2915.0,1
1,1,302,572,1,0.5270506108202443,874,437.0,0
1,2,147,110,4,1.3243243243243243,257,51.4,0
0,1,669,262,3,2.543726235741445,931,232.75,0
0,3,1283,1046,18,1.2254059216809934,2329,122.57894736842105,0
2,2,3498,11,43,291.5,3509,79.75,0
0,0,1979,2222,97,0.890238416554206,4201,42.86734693877551,0
1,2,228,471,16,0.4830508474576271,699,41.11764705882353,0
1,2,1272,588,34,2.159592529711375,1860,53.142857142857146,0
1,2,341,3566,30,0.09559854219231848,3907,126.03225806451613,0
1,2,1150,559,14,2.0535714285714284,1709,113.93333333333334,0
2,0,1096,2361,38,0.4640135478408129,3457,88.64102564102564,0
2,0,318,1974,26,0.1610126582278481,2292,84.88888888888889,0
0,0,267,2268,42,0.11767298369325695,2535,58.95348837209303,0
0,2,109,1338,6,0.08140403286034353,1447,206.71428571428572,0
0,3,51,281,13,0.18085106382978725,332,23.714285714285715,0
2,3,1955,340,33,5.733137829912024,2295,67.5,0
1,0,51,363,3,0.1401098901098901,414,103.5,0
0,3,92,3097,44,0.029696578437701744,3189,70.86666666666666,0
1,3,272,357,4,0.7597765363128491,629,125.8,0
0,3,2186,92,11,23.50537634408602,2278,189.83333333333334,0
0,3,404,1205,8,0.33499170812603646,1609,178.77777777777777,0
0,3,212,364,1,0.5808219178082191,576,288.0,0
0,1,1257,776,9,1.6177606177606179,2033,203.3,0
0,0,384,2065,72,0.18586640851887706,2449,33.54794520547945,0
1,2,405,685,0,0.5903790087463557,1090,1090.0,0
0,3,1343,812,0,1.6519065190651907,2155,2155.0,0
1,1,289,823,36,0.35072815533980584,1112,30.054054054054053,0
2,2,2270,758,13,2.9907773386034258,3028,216.28571428571428,0
0,1,824,139,7,5.885714285714286,963,120.375,0
1,3,771,487,21,1.5799180327868851,1258,57.18181818181818,0
2,3,307,6,9,43.857142857142854,313,31.3,1
2,3,1802,787,14,2.286802030456853,2589,172.6,0
2,3,850,685,37,1.239067055393586,1535,40.39473684210526,0
1,2,169,306,3,0.5504885993485342,475,118.75,0
0,2,231,593,96,0.3888888888888889,824,8.494845360824742,0
0,1,631,543,1,1.1599264705882353,1174,587.0,0
1,0,1512,231,49,6.517241379310345,1743,34.86,0
0,3,2801,277,38,10.075539568345324,3078,78.92307692307692,0
1,1,1089,1150,9,0.946133796698523,2239,223.9,0
0,1,705,1127,3,0.625,1832,458.0,0
2,1,288,507,57,0.5669291338582677,795,13.706896551724139,0
0,3,1117,1011,34,1.1037549407114624,2128,60.8,0
1,3,4030,479,10,8.395833333333334,4509,409.90909090909093,0
1,1,646,1525,0,0.4233289646133683,2171,2171.0,1
2,3,176,323,83,0.5432098765432098,499,5.940476190476191,0
1,1,109,2097,15,0.051954242135367014,2206,137.875,0
0,2,313,625,5,0.5,938,156.33333333333334,0
0,3,842,613,72,1.3713355048859934,1455,19.931506849315067,0
2,2,2933,888,13,3.2992125984251968,3821,272.92857142857144,0
1,0,355,333,18,1.062874251497006,688,36.21052631578947,0
2,3,364,1030,35,0.3530552861299709,1394,38.72222222222222,0
0,0,656,309,51,2.1161290322580646,965,18.557692307692307,0
2,1,2507,405,3,6.174876847290641,2912,728.0,1
1,3,543,898,68,0.6040044493882091,1441,20.884057971014492,0
2,3,252,380,80,0.6614173228346457,632,7.802469135802469,0
1,3,178,178,9,0.994413407821229,356,35.6,0
1,0,610,1643,20,0.3710462287104623,2253,107.28571428571429,0
0,0,1612,2042,58,0.7890357317670093,3654,61.932203389830505,0
0,1,344,788,20,0.43599493029150826,1132,53.904761904761905,0
0,2,718,1333,19,0.5382308845577212,2051,102.55,0
1,2,923,3453,28,0.26722640416907933,4376,150.89655172413794,0
2,0,598,763,43,0.7827225130890052,1361,30.931818181818183,0
1,3,212,1915,32,0.11064718162839249,2127,64.45454545454545,0
0,2,2547,356,29,7.1344537815126055,2903,96.76666666666667,0
0,2,833,964,13,0.8632124352331606,1797,128.35714285714286,0
2,0,1306,45,29,28.391304347826086,1351,45.03333333333333,1
0,1,1010,1244,3,0.8112449799196787,2254,563.5,0
0,0,6238,1416,15,4.402258292166549,7654,478.375,1
0,0,609,410,6,1.4817518248175183,1019,145.57142857142858,0
2,3,553,815,23,0.6776960784313726,1368,57.0,0
1,0,446,1563,9,0.2851662404092072,2009,200.9,0
0,3,448,1720,21,0.26031377106333525,2168,98.54545454545455,0
2,1,322,90,45,3.5384615384615383,412,8.956521739130435,0
0,3,3944,1405,17,2.805120910384068,5349,297.1666666666667,0
2,1,2046,256,7,7.961089494163424,2302,287.75,0
0,1,380,1039,7,0.36538461538461536,1419,177.375,0
2,1,364,314,71,1.1555555555555554,678,9.416666666666666,0
0,0,109,46,45,2.3191489361702127,155,3.369565217391304,0
1,3,2095,188,1,11.084656084656086,2283,1141.5,1
0,2,464,420,85,1.1021377672209025,884,10.279069767441861,0
2,0,850,1081,3,0.7855822550831792,1931,482.75,0
0,1,2306,84,31,27.129411764705882,2390,74.6875,0
1,2,524,1341,24,0.39046199701937406,1865,74.6,0
0,0,1644,4634,1,0.3546925566343042,6278,3139.0,1
2,2,562,1241,10,0.4524959742351047,1803,163.9090909090909,0
2,1,1207,513,44,2.348249027237354,1720,38.22222222222222,0
1,2,564,671,10,0.8392857142857143,1235,112.27272727272727,0
2,2,498,4,19,99.6,502,25.1,0
0,1,4678,187,35,24.882978723404257,4865,135.13888888888889,0
0,2,947,1834,2,0.5160762942779291,2781,927.0,0
0,0,457,17,53,25.38888888888889,474,8.777777777777779,1
2,2,298,1881,1,0.15834218916046758,2179,1089.5,0
0,3,40,96,9,0.41237113402061853,136,13.6,0
0,0,1226,114,43,10.660869565217391,1340,30.454545454545453,1
0,2,465,154,72,3.0,619,8.479452054794521,0
1,3,1721,1285,42,1.3382581648522551,3006,69.90697674418605,0
2,3,452,520,7,0.8675623800383877,972,121.5,0
2,3,467,125,127,3.7063492063492065,592,4.625,1
2,2,1510,928,15,1.6254036598493002,2438,152.375,0
1,1,672,2259,14,0.2973451327433628,2931,195.4,0
2,3,2161,679,60,3.177941176470588,2840,46.557377049180324,0
1,1,891,83,2,10.607142857142858,974,324.6666666666667,0
1,0,275,45,24,5.978260869565218,320,12.8,1
2,1,839,1271,101,0.6595911949685535,2110,20.686274509803923,0
0,1,4,786,3,0.005082592121982211,790,197.5,0
0,1,374,2047,23,0.1826171875,2421,100.875,0
2,1,233,633,4,0.3675078864353312,866,173.2,0
2,1,1061,51,66,20.403846153846153,1112,16.597014925373134,0
1,0,146,413,26,0.3526570048309179,559,20.703703703703702,0
2,0,342,858,8,0.3981373690337602,1200,133.33333333333334,0
1,1,402,388,11,1.0334190231362468,790,65.83333333333333,0
2,1,3,6242,21,0.0004805382027871216,6245,283.8636363636364,0
0,3,47,415,38,0.11298076923076923,462,11.846153846153847,0
0,0,372,632,20,0.5876777251184834,1004,47.80952380952381,0
2,2,251,204,6,1.224390243902439,455,65.0,0
1,0,124,132,36,0.9323308270676691,256,6.918918918918919,0
0,2,167,829,3,0.20120481927710843,996,249.0,0
1,3,1805,710,49,2.538677918424754,2515,50.3,0
2,1,1149,3,15,287.25,1152,72.0,1
2,3,661,268,31,2.45724907063197,929,29.03125,0
0,1,2395,825,12,2.8995157384987893,3220,247.69230769230768,0
2,0,29,1338,33,0.021657953696788648,1367,40.205882352941174,0
0,1,423,299,65,1.41,722,10.93939393939394,0
1,2,1733,834,36,2.075449101796407,2567,69.37837837837837,0
0,2,989,246,33,4.004048582995951,1235,36.3235294117647,0
0,3,4000,937,42,4.264392324093817,4937,114.81395348837209,1
1,0,2891,957,20,3.0177453027139873,3848,183.23809523809524,0
0,2,186,111,7,1.6607142857142858,297,37.125,0
0,3,3575,875,50,4.081050228310502,4450,87.25490196078431,1
2,0,2910,324,31,8.953846153846154,3234,101.0625,0
1,0,467,151,11,3.0723684210526314,618,51.5,0
0,3,4067,555,9,7.3147482014388485,4622,462.2,0
1,2,36,481,20,0.07468879668049792,517,24.61904761904762,0
1,2,1081,1189,6,0.9084033613445378,2270,324.2857142857143,0
0,3,309,70,63,4.352112676056338,379,5.921875,0
2,2,138,1247,46,0.11057692307692307,1385,29.46808510638298,0
1,3,861,89,11,9.566666666666666,950,79.16666666666667,1
0,2,365,186,1,1.9518716577540107,551,275.5,0
1,2,1099,580,1,1.891566265060241,1679,839.5,0
2,3,776,497,10,1.5582329317269077,1273,115.72727272727273,0
2,3,498,3597,4,0.13841022790439134,4095,819.0,0
2,2,200,712,61,0.2805049088359046,912,14.709677419354838,0
0,3,919,317,16,2.889937106918239,1236,72.70588235294117,0
0,2,1767,1843,12,0.9582429501084598,3610,277.6923076923077,0
2,1,916,299,7,3.0533333333333332,1215,151.875,0
0,0,942,255,55,3.6796875,1197,21.375,1
2,0,717,545,47,1.3131868131868132,1262,26.291666666666668,0
0,2,491,1955,14,0.25102249488752554,2446,163.06666666666666,0
2,0,611,986,5,0.6190476190476191,1597,266.1666666666667,0
1,2,4560,905,91,5.033112582781457,5465,59.40217391304348,1
2,3,1384,1035,11,1.335907335907336,2419,201.58333333333334,0
2,1,563,862,44,0.6523754345307068,1425,31.666666666666668,0
0,0,611,1141,18,0.5350262697022767,1752,92.21052631578948,0
0,0,692,171,45,4.023255813953488,863,18.76086956521739,0
0,3,1076,156,19,6.853503184713376,1232,61.6,0
0,1,627,359,77,1.7416666666666667,986,12.64102564102564,0
0,1,1158,1522,48,0.7603414313854235,2680,54.69387755102041,0
0,1,399,1002,9,0.39780658025922233,1401,140.1,0
1,3,528,668,16,0.7892376681614349,1196,70.3529411764706,0
2,0,1995,15,3,124.6875,2010,502.5,0
2,0,398,215,70,1.8425925925925926,613,8.633802816901408,0
2,1,3336,1301,2,2.5622119815668203,4637,1545.6666666666667,0
1,3,189,222,0,0.8475336322869955,411,411.0,0
2,3,276,1048,20,0.2631077216396568,1324,63.04761904761905,0
1,3,623,163,27,3.798780487804878,786,28.071428571428573,0
1,1,1596,745,7,2.1394101876675604,2341,292.625,0
1,3,1315,791,25,1.6603535353535352,2106,81.0,0
2,1,191,1115,67,0.17114695340501793,1306,19.205882352941178,0
1,1,270,461,29,0.5844155844155844,731,24.366666666666667,0
2,1,856,801,18,1.0673316708229426,1657,87.21052631578948,0
2,2,349,533,4,0.653558052434457,882,176.4,0
0,1,548,2355,5,0.23259762308998302,2903,483.8333333333333,0
0,3,666,590,19,1.1269035532994924,1256,62.8,0
1,2,902,188,18,4.772486772486772,1090,57.36842105263158,1
1,0,289,881,22,0.3276643990929705,1170,50.869565217391305,0
2,0,178,636,21,0.2794348508634223,814,37.0,0
1,3,508,1303,12,0.3895705521472393,1811,139.30769230769232,0
1,3,85,155,35,0.5448717948717948,240,6.666666666666667,0
2,3,748,241,7,3.090909090909091,989,123.625,0
1,3,1830,2037,57,0.8979391560353287,3867,66.67241379310344,0
1,2,126,2127,6,0.05921052631578947,2253,321.85714285714283,0
2,3,119,467,16,0.25427350427350426,586,34.470588235294116,0
2,1,83,39,7,2.075,122,15.25,0
0,0,1882,292,28,6.42320819112628,2174,74.96551724137932,0
2,3,84,227,19,0.3684210526315789,311,15.55,0
0,1,4102,428,14,9.561771561771561,4530,302.0,0
1,3,443,305,19,1.4477124183006536,748,37.4,0
2,1,398,1412,16,0.2816702052370842,1810,106.47058823529412,0
2,2,96,2,57,32.0,98,1.6896551724137931,0
2,0,881,827,3,1.0640096618357489,1708,427.0,0
1,0,881,873,47,1.0080091533180777,1754,36.541666666666664,0
0,2,680,864,31,0.7861271676300579,1544,48.25,0
1,1,372,588,12,0.631578947368421,960,73.84615384615384,0
1,3,459,755,75,0.6071428571428571,1214,15.973684210526315,0
2,1,386,1330,5,0.290007513148009,1716,286.0,0
0,0,555,1226,11,0.45232273838630804,1781,148.41666666666666,0
1,2,418,28,14,14.413793103448276,446,29.733333333333334,0
2,2,1125,24,31,45.0,1149,35.90625,1
1,1,350,1460,87,0.23956194387405885,1810,20.568181818181817,0
1,1,432,684,27,0.6306569343065693,1116,39.857142857142854,0
2,2,571,2525,58,0.22604908946951702,3096,52.47457627118644,0
2,0,3,451,70,0.00663716814159292,454,6.394366197183099,0
0,3,677,155,18,4.339743589743589,832,43.78947368421053,0
1,3,295,512,19,0.5750487329434698,807,40.35,0
2,1,57,458,8,0.12418300653594772,515,57.22222222222222,0
2,2,2419,582,27,4.149228130360206,3001,107.17857142857143,0
0,2,389,1319,3,0.2946969696969697,1708,427.0,0
0,2,555,852,30,0.6506447831184057,1407,45.38709677419355,0
2,0,1756,163,67,10.707317073170731,1919,28.220588235294116,1
0,1,182,1060,42,0.17153628652214892,1242,28.88372093023256,0
2,1,1899,716,31,2.6485355648535567,2615,81.71875,0
1,1,276,690,54,0.3994211287988423,966,17.563636363636363,0
0,0,889,907,39,0.9790748898678414,1796,44.9,0
1,1,1157,664,22,1.7398496240601504,1821,79.17391304347827,0
1,3,2354,489,22,4.8040816326530615,2843,123.6086956521739,0
1,1,935,818,3,1.1416361416361416,1753,438.25,0
2,1,603,1029,17,0.5854368932038835,1632,90.66666666666667,0
1,1,849,204,22,4.1414634146341465,1053,45.78260869565217,0
1,0,225,549,19,0.4090909090909091,774,38.7,0
1,3,1168,490,44,2.378818737270876,1658,36.84444444444444,0
2,3,206,32,5,6.242424242424242,238,39.666666666666664,1
1,2,814,1438,47,0.5656706045865184,2252,46.916666666666664,0
1,2,1042,379,40,2.7421052631578946,1421,34.65853658536585,0
0,3,2288,60,69,37.50819672131148,2348,33.542857142857144,0
2,1,598,489,14,1.220408163265306,1087,72.46666666666667,0
1,1,1493,140,5,10.588652482269504,1633,272.1666666666667,1
0,1,183,975,42,0.1875,1158,26.930232558139537,0
2,0,169,678,26,0.24889543446244478,847,31.37037037037037,0
2,1,744,251,37,2.9523809523809526,995,26.18421052631579,0
2,0,907,2404,171,0.37713097713097715,3311,19.25,0
2,3,1000,275,6,3.6231884057971016,1275,182.14285714285714,1
2,1,1369,647,15,2.1126543209876543,2016,126.0,0
2,1,349,1293,6,0.2697063369397218,1642,234.57142857142858,0
1,2,974,577,59,1.685121107266436,1551,25.85,0
1,3,208,2592,0,0.0802159660624759,2800,2800.0,0
1,1,247,1485,4,0.16621803499327054,1732,346.4,0
1,0,69,2030,8,0.033973412112259974,2099,233.22222222222223,0
0,3,1374,373,44,3.6737967914438503,1747,38.82222222222222,0
1,2,707,635,29,1.1116352201257862,1342,44.733333333333334,0
2,3,272,1466,14,0.18541240627130198,1738,115.86666666666666,0
1,0,812,1870,5,0.4339925173703902,2682,447.0,0
1,2,437,2311,11,0.18901384083044984,2748,229.0,0
2,0,1815,1690,40,1.0733293908929626,3505,85.48780487804878,0
1,3,751,1049,14,0.7152380952380952,1800,120.0,0
1,2,30,19,18,1.5,49,2.5789473684210527,0
1,0,4206,302,28,13.881188118811881,4508,155.44827586206895,1
0,3,77,110,73,0.6936936936936937,187,2.527027027027027,0
1,0,1190,134,8,8.814814814814815,1324,147.11111111111111,1
2,1,574,275,17,2.079710144927536,849,47.166666666666664,0
2,3,286,62,11,4.5396825396825395,348,29.0,1
1,2,1128,222,18,5.058295964125561,1350,71.05263157894737,0
1,2,134,2516,35,0.05323798172427493,2650,73.61111111111111,0
1,1,1953,299,19,6.51,2252,112.6,0
2,0,288,139,53,2.057142857142857,427,7.907407407407407,0
2,0,448,1013,24,0.4418145956607495,1461,58.44,0
0,2,1001,1410,14,0.7094259390503189,2411,160.73333333333332,0
0,0,1,301,45,0.0033112582781456954,302,6.565217391304348,0
0,3,640,261,16,2.4427480916030535,901,53.0,0
2,3,2246,221,21,10.117117117117116,2467,112.13636363636364,0
0,2,1140,399,157,2.85,1539,9.740506329113924,0
1,3,490,73,46,6.621621621621622,563,11.97872340425532,0
1,2,1080,884,57,1.2203389830508475,1964,33.86206896551724,0
2,0,2757,1381,26,1.9949348769898698,4138,153.25925925925927,0
0,0,208,871,12,0.23853211009174313,1079,83.0,0
1,0,758,437,142,1.730593607305936,1195,8.356643356643357,0
2,1,267,272,8,0.978021978021978,539,59.888888888888886,0
0,2,1925,421,61,4.561611374407583,2346,37.83870967741935,0
1,3,1276,441,72,2.8868778280542986,1717,23.52054794520548,0
0,0,1614,877,51,1.8382687927107062,2491,47.90384615384615,0
2,1,2864,2105,3,1.3599240265906933,4969,1242.25,0
0,3,264,58,57,4.47457627118644,322,5.551724137931035,0
2,3,49,2452,32,0.019975540154912354,2501,75.78787878787878,0
0,3,343,1928,34,0.1778123379989632,2271,64.88571428571429,0
1,0,509,100,46,5.03960396039604,609,12.957446808510639,0
2,3,981,162,20,6.0184049079754605,1143,54.42857142857143,0
2,2,1598,298,9,5.344481605351171,1896,189.6,0
2,1,430,656,25,0.654490106544901,1086,41.76923076923077,0
0,3,641,115,3,5.525862068965517,756,189.0,0
0,3,1539,178,33,8.597765363128492,1717,50.5,0
1,2,255,1863,19,0.13680257510729613,2118,105.9,0
2,3,244,92,20,2.6236559139784945,336,16.0,0
2,0,889,407,6,2.178921568627451,1296,185.14285714285714,0
0,0,572,1151,1,0.4965277777777778,1723,861.5,0
0,0,2973,1755,28,1.6930523917995444,4728,163.0344827586207,1
1,3,441,327,32,1.3445121951219512,768,23.272727272727273,0
1,1,1425,143,20,9.895833333333334,1568,74.66666666666667,0
0,1,874,1068,43,0.8175865294667914,1942,44.13636363636363,0
2,3,56,1184,24,0.04725738396624472,1240,49.6,0
1,1,88,3130,56,0.02810603641009262,3218,56.45614035087719,0
0,1,227,120,10,1.8760330578512396,347,31.545454545454547,0
0,3,154,988,8,0.1557128412537917,1142,126.88888888888889,0
2,0,399,432,9,0.9214780600461894,831,83.1,0
0,3,865,1968,0,0.4393092940578974,2833,2833.0,0
0,0,922,419,69,2.1952380952380954,1341,19.15714285714286,0
1,0,886,472,213,1.8731501057082451,1358,6.345794392523365,0
0,1,125,108,50,1.146788990825688,233,4.568627450980392,0
0,1,916,309,15,2.9548387096774196,1225,76.5625,0
1,0,527,409,13,1.2853658536585366,936,66.85714285714286,0
2,0,2333,14,44,155.53333333333333,2347,52.15555555555556,0
2,1,2430,460,21,5.27114967462039,2890,131.36363636363637,0
1,2,1461,327,84,4.454268292682927,1788,21.03529411764706,1
1,0,1214,1303,9,0.9309815950920245,2517,251.7,0
2,0,122,90,11,1.3406593406593406,212,17.666666666666668,0
2,0,88,1142,202,0.07699037620297462,1230,6.059113300492611,0
2,1,1837,1001,114,1.8333333333333333,2838,24.678260869565218,0
2,3,556,221,64,2.5045045045045047,777,11.953846153846154,0
2,0,600,69,15,8.571428571428571,669,41.8125,1
1,0,1882,1475,54,1.2750677506775068,3357,61.03636363636364,0
0,0,971,229,9,4.221739130434782,1200,120.0,0
2,3,197,125,8,1.5634920634920635,322,35.77777777777778,0
2,3,237,355,23,0.6657303370786517,592,24.666666666666668,0
0,0,6,409,59,0.014634146341463415,415,6.916666666666667,0
0,0,1240,315,3,3.9240506329113924,1555,388.75,0
0,2,664,2999,24,0.22133333333333333,3663,146.52,0
0,3,2995,1701,28,1.7596944770857814,4696,161.93103448275863,0
0,2,1251,1650,26,0.7577225923682617,2901,107.44444444444444,0
0,0,108,407,7,0.2647058823529412,515,64.375,0
1,0,176,2634,1,0.0667931688804554,2810,1405.0,0
0,0,696,921,67,0.754880694143167,1617,23.779411764705884,0
0,0,2588,1427,25,1.8123249299719888,4015,154.42307692307693,0
1,1,284,555,43,0.5107913669064749,839,19.068181818181817,0
0,1,1746,140,13,12.382978723404255,1886,134.71428571428572,0
2,1,374,1743,1,0.21444954128440366,2117,1058.5,0
2,2,314,533,9,0.5880149812734082,847,84.7,0
0,3,2316,2767,2,0.8367052023121387,5083,1694.3333333333333,0
1,0,48,235,2,0.2033898305084746,283,94.33333333333333,0
2,3,1080,3901,7,0.2767811378780113,4981,622.625,1
1,1,44,201,30,0.21782178217821782,245,7.903225806451613,0
2,0,1613,367,51,4.383152173913044,1980,38.07692307692308,1
0,0,1768,721,51,2.4487534626038783,2489,47.86538461538461,0
1,2,2238,945,83,2.365750528541226,3183,37.892857142857146,0
1,3,205,1019,32,0.20098039215686275,1224,37.09090909090909,0
1,2,132,517,0,0.2548262548262548,649,649.0,0
2,1,700,63,14,10.9375,763,50.86666666666667,0
2,3,316,548,3,0.575591985428051,864,216.0,0
2,1,932,325,45,2.8588957055214723,1257,27.32608695652174,0
0,2,721,857,3,0.8403263403263403,1578,394.5,0
2,2,156,160,3,0.968944099378882,316,79.0,0
0,0,1344,400,0,3.3516209476309227,1744,1744.0,0
1,3,1628,2707,93,0.6011816838995568,4335,46.11702127659574,1
1,3,3298,74,46,43.973333333333336,3372,71.74468085106383,0
0,0,503,737,12,0.6815718157181572,1240,95.38461538461539,0
2,3,412,76,14,5.35064935064935,488,32.53333333333333,0
0,1,213,136,1,1.5547445255474452,349,174.5,0
1,1,199,742,5,0.26783310901749663,941,156.83333333333334,0
1,2,387,469,11,0.823404255319149,856,71.33333333333333,0
0,1,4007,636,14,6.2904238618524335,4643,309.53333333333336,0
2,3,96,1695,29,0.05660377358490566,1791,59.7,0
2,0,300,1359,12,0.22058823529411764,1659,127.61538461538461,0
0,2,89,1751,92,0.050799086757990865,1840,19.78494623655914,0
0,0,319,766,12,0.41590612777053454,1085,83.46153846153847,0
2,2,96,538,85,0.17810760667903525,634,7.372093023255814,0
1,2,709,491,39,1.4410569105691058,1200,30.0,0
0,0,576,1077,69,0.5343228200371057,1653,23.614285714285714,0
2,1,191,589,36,0.32372881355932204,780,21.08108108108108,0
2,1,192,89,25,2.1333333333333333,281,10.807692307692308,0
1,1,983,122,21,7.991869918699187,1105,50.22727272727273,0
1,1,489,353,10,1.38135593220339,842,76.54545454545455,0
1,0,57,56,10,1.0,113,10.272727272727273,0
1,3,2528,218,7,11.54337899543379,2746,343.25,0
1,2,519,854,14,0.6070175438596491,1373,91.53333333333333,0
0,0,894,10,4,81.27272727272727,904,180.8,1
2,1,2166,741,14,2.9191374663072778,2907,193.8,0
0,1,514,1183,53,0.4341216216216216,1697,31.425925925925927,0
0,0,1718,149,61,11.453333333333333,1867,30.112903225806452,1
0,2,2462,159,30,15.3875,2621,84.54838709677419,0
0,0,191,23,8,7.958333333333333,214,23.77777777777778,1
0,0,2230,574,8,3.878260869565217,2804,311.55555555555554,0
1,3,127,850,9,0.1492361927144536,977,97.7,0
1,0,321,488,20,0.656441717791411,809,38.523809523809526,0
2,3,1651,394,112,4.179746835443038,2045,18.097345132743364,0
0,2,2309,484,3,4.760824742268041,2793,698.25,0
2,0,1152,1216,20,0.9465899753492194,2368,112.76190476190476,0
1,0,110,27,34,3.9285714285714284,137,3.914285714285714,0
1,1,740,1225,8,0.6035889070146819,1965,218.33333333333334,0
1,0,850,878,104,0.9670079635949943,1728,16.457142857142856,0
0,1,331,221,12,1.490990990990991,552,42.46153846153846,0
0,1,4743,595,80,7.958053691275167,5338,65.90123456790124,1
1,1,408,40,27,9.951219512195122,448,16.0,0
2,2,236,381,0,0.6178010471204188,617,617.0,0
2,3,116,152,11,0.7581699346405228,268,22.333333333333332,0
1,1,475,18,0,25.0,493,493.0,1
2,0,1179,353,14,3.330508474576271,1532,102.13333333333334,0
1,0,263,1036,80,0.2536162005785921,1299,16.037037037037038,0
2,1,1467,2030,45,0.7223042836041359,3497,76.02173913043478,0
1,1,145,868,29,0.1668584579976985,1013,33.766666666666666,0
2,0,580,411,23,1.4077669902912622,991,41.291666666666664,0
0,1,1211,6074,13,0.19934156378600823,7285,520.3571428571429,0
1,3,145,266,7,0.5430711610486891,411,51.375,0
1,3,910,165,1,5.481927710843373,1075,537.5,1
2,2,1604,498,6,3.214428857715431,2102,300.2857142857143,0
1,1,905,562,12,1.6074600355239788,1467,112.84615384615384,0
1,2,716,350,22,2.03988603988604,1066,46.34782608695652,0
1,2,1822,951,6,1.9138655462184875,2773,396.14285714285717,0
0,2,4228,162,109,25.938650306748468,4390,39.90909090909091,1
0,1,200,571,2,0.34965034965034963,771,257.0,0
2,2,1175,554,2,2.1171171171171173,1729,576.3333333333334,0
0,3,84,1388,34,0.06047516198704104,1472,42.05714285714286,0
2,2,43,2093,42,0.020534861509073542,2136,49.674418604651166,0
0,3,329,870,107,0.3777267508610792,1199,11.101851851851851,0
2,3,3537,291,22,12.113013698630137,3828,166.43478260869566,0
0,1,803,935,5,0.8579059829059829,1738,289.6666666666667,0
0,2,312,231,83,1.3448275862068966,543,6.464285714285714,0
2,1,142,2718,117,0.0522250827510114,2860,24.23728813559322,0
1,3,2528,1382,77,1.8279103398409255,3910,50.12820512820513,0
1,0,449,451,61,0.9933628318584071,900,14.516129032258064,0
0,2,366,1227,2,0.2980456026058632,1593,531.0,0
2,1,1951,420,57,4.634204275534442,2371,40.87931034482759,0
1,0,927,62,91,14.714285714285714,989,10.75,0
2,2,184,981,24,0.18737270875763748,1165,46.6,0
1,2,547,414,44,1.3180722891566266,961,21.355555555555554,0
2,1,2634,2131,32,1.2354596622889307,4765,144.3939393939394,1
0,0,2314,292,10,7.897610921501706,2606,236.9090909090909,0
2,1,72,1482,26,0.048550236008091704,1554,57.55555555555556,0
1,2,312,912,66,0.3417305585980285,1224,18.26865671641791,0
0,2,167,1535,20,0.10872395833333333,1702,81.04761904761905,0
2,3,763,276,26,2.7545126353790614,1039,38.48148148148148,0
1,2,1386,494,22,2.8,1880,81.73913043478261,0
0,2,350,1385,9,0.25252525252525254,1735,173.5,0
2,0,1418,825,30,1.7167070217917675,2243,72.35483870967742,0
1,0,1104,356,21,3.092436974789916,1460,66.36363636363636,1
2,3,1302,573,7,2.268292682926829,1875,234.375,0
2,3,2961,4437,67,0.667192429022082,7398,108.79411764705883,0
0,3,552,1083,89,0.5092250922509225,1635,18.166666666666668,0
0,1,419,762,1,0.5491480996068152,1181,590.5,0
1,1,1151,1407,29,0.8174715909090909,2558,85.26666666666667,0
0,3,1647,466,16,3.526766595289079,2113,124.29411764705883,1
1,1,212,2397,22,0.0884070058381985,2609,113.43478260869566,0
2,2,1876,642,14,2.9175738724727838,2518,167.86666666666667,0
2,3,59,316,19,0.1861198738170347,375,18.75,0
1,3,6,71,11,0.08333333333333333,77,6.416666666666667,0
2,1,172,376,3,0.4562334217506631,548,137.0,0
0,0,3847,672,10,5.716196136701337,4519,410.8181818181818,1
2,3,741,971,33,0.7623456790123457,1712,50.35294117647059,0
0,1,47,1664,1,0.02822822822822823,1711,855.5,0
1,1,5869,2305,14,2.5450997398091935,8174,544.9333333333333,0
1,0,1366,86,1,15.701149425287356,1452,726.0,0
2,3,1820,734,13,2.4761904761904763,2554,182.42857142857142,0
2,0,239,878,2,0.27189988623435724,1117,372.3333333333333,0
0,2,111,151,12,0.7302631578947368,262,20.153846153846153,0
0,0,723,631,54,1.143987341772152,1354,24.618181818181817,0
2,0,1479,326,28,4.522935779816514,1805,62.241379310344826,0
2,1,1015,64,34,15.615384615384615,1079,30.82857142857143,0
1,0,997,54,21,18.12727272727273,1051,47.77272727272727,1
1,2,1415,1139,76,1.2412280701754386,2554,33.16883116883117,0
1,1,257,764,23,0.3359477124183007,1021,42.541666666666664,0
2,2,1083,1004,3,1.0776119402985074,2087,521.75,0
2,0,497,924,81,0.5372972972972972,1421,17.329268292682926,0
2,2,72,115,4,0.6206896551724138,187,37.4,0
1,2,225,131,212,1.7045454545454546,356,1.6713615023474178,0
2,0,1579,232,17,6.776824034334764,1811,100.61111111111111,0
0,0,2262,407,2,5.544117647058823,2669,889.6666666666666,0
2,1,332,2239,59,0.14821428571428572,2571,42.85,0
2,1,211,896,2,0.23522853957636566,1107,369.0,0
2,3,27,235,5,0.11440677966101695,262,43.666666666666664,0
2,1,2950,46,16,62.765957446808514,2996,176.23529411764707,0
2,0,1151,922,33,1.2470205850487541,2073,60.970588235294116,0
0,2,3147,785,3,4.0038167938931295,3932,983.0,1
0,2,1993,901,29,2.2095343680709534,2894,96.46666666666667,0
2,1,416,242,45,1.7119341563786008,658,14.304347826086957,0
1,1,119,582,3,0.20411663807890223,701,175.25,0
2,0,691,359,31,1.9194444444444445,1050,32.8125,0
2,2,27,1361,95,0.019823788546255508,1388,14.458333333333334,0
2,3,162,57,102,2.793103448275862,219,2.1262135922330097,0
1,3,265,257,5,1.0271317829457365,522,87.0,0
1,1,1095,738,42,1.4817320703653587,1833,42.627906976744185,0
1,3,713,183,56,3.875,896,15.719298245614034,0
0,0,360,893,65,0.40268456375838924,1253,18.984848484848484,0
1,3,831,117,11,7.0423728813559325,948,79.0,0
0,1,133,18,9,7.0,151,15.1,0
0,0,1409,1593,1,0.883939774153074,3002,1501.0,0
1,2,1244,324,15,3.8276923076923075,1568,98.0,0
1,0,243,136,3,1.7737226277372262,379,94.75,0
1,1,932,151,46,6.131578947368421,1083,23.04255319148936,0
0,1,699,1736,4,0.40241796200345425,2435,487.0,0
2,3,62,850,51,0.07285546415981199,912,17.53846153846154,0
1,3,325,2505,3,0.12968874700718275,2830,707.5,0
1,2,7566,1287,19,5.874223602484472,8853,442.65,0
1,2,104,1167,14,0.08904109589041095,1271,84.73333333333333,0
0,1,706,554,27,1.2720720720720722,1260,45.0,0
0,1,1892,1375,21,1.375,3267,148.5,0
2,1,357,425,27,0.8380281690140845,782,27.928571428571427,0
1,2,302,1403,0,0.2150997150997151,1705,1705.0,0
0,1,2214,1134,4,1.9506607929515418,3348,669.6,0
2,2,363,907,21,0.3997797356828194,1270,57.72727272727273,0
1,1,1054,320,7,3.283489096573209,1374,171.75,0
0,0,1348,796,2,1.6913425345043915,2144,714.6666666666666,0
1,0,1554,565,7,2.745583038869258,2119,264.875,0
1,1,5251,495,45,10.586693548387096,5746,124.91304347826087,1
0,0,1625,3704,23,0.43859649122807015,5329,222.04166666666666,0
0,2,1070,561,6,1.903914590747331,1631,233.0,0
0,3,2258,26,0,83.62962962962963,2284,2284.0,0
1,0,2361,787,13,2.996192893401015,3148,224.85714285714286,0
1,3,3618,1041,13,3.4721689059500958,4659,332.7857142857143,1
2,0,1498,1731,39,0.8648960739030023,3229,80.725,0
1,2,216,801,75,0.26932668329177056,1017,13.381578947368421,0
0,0,1237,15,13,77.3125,1252,89.42857142857143,0
1,0,78,102,34,0.7572815533980582,180,5.142857142857143,0
2,1,382,140,30,2.7092198581560285,522,16.838709677419356,0
2,3,123,189,16,0.6473684210526316,312,18.352941176470587,0
0,3,2994,1286,2,2.3263403263403264,4280,1426.6666666666667,0
0,2,413,296,19,1.3905723905723906,709,35.45,0
2,2,1249,299,13,4.163333333333333,1548,110.57142857142857,1
2,3,847,1127,23,0.750886524822695,1974,82.25,0
2,1,113,425,4,0.2652582159624413,538,107.6,0
0,1,824,53,38,15.25925925925926,877,22.487179487179485,1
2,3,1081,703,46,1.5355113636363635,1784,37.95744680851064,0
2,0,2132,111,14,19.035714285714285,2243,149.53333333333333,0
0,3,72,678,5,0.10603829160530191,750,125.0,0
1,0,350,1209,29,0.2892561983471074,1559,51.96666666666667,0
1,3,1178,2121,93,0.5551366635249765,3299,35.09574468085106,0
2,0,34,55,36,0.6071428571428571,89,2.4054054054054053,0
1,1,227,289,3,0.7827586206896552,516,129.0,0
1,3,246,845,15,0.2907801418439716,1091,68.1875,0
1,2,1106,303,74,3.638157894736842,1409,18.786666666666665,0
1,0,336,479,30,0.7,815,26.29032258064516,0
2,1,915,16,4,53.8235294117647,931,186.2,1
1,2,3362,946,38,3.550158394931362,4308,110.46153846153847,0
1,1,1576,1718,13,0.9168121000581734,3294,235.28571428571428,0
0,0,404,3012,20,0.13408562894125456,3416,162.66666666666666,0
2,3,639,1420,16,0.44968332160450386,2059,121.11764705882354,0
0,1,223,25,38,8.576923076923077,248,6.358974358974359,1
0,3,15,844,7,0.01775147928994083,859,107.375,0
2,3,342,547,14,0.6240875912408759,889,59.266666666666666,0
1,1,461,2223,40,0.2072841726618705,2684,65.46341463414635,0
0,1,830,1859,36,0.44623655913978494,2689,72.67567567567568,0
2,1,2883,3541,6,0.8139469226425748,6424,917.7142857142857,1
1,3,2953,1584,12,1.8630914826498424,4537,349.0,1
2,2,72,633,0,0.11356466876971609,705,705.0,0
0,0,953,1003,22,0.9492031872509961,1956,85.04347826086956,0
1,2,43,2674,9,0.016074766355140185,2717,271.7,0
1,3,1044,690,0,1.5108538350217078,1734,1734.0,0
2,1,125,1465,16,0.08526603001364257,1590,93.52941176470588,0
1,1,2926,2280,78,1.28277071459886,5206,65.89873417721519,1
0,0,1997,676,77,2.949778434268833,2673,34.26923076923077,0
0,0,22,138,13,0.15827338129496402,160,11.428571428571429,0
0,2,1523,135,17,11.198529411764707,1658,92.11111111111111,0
2,2,1010,98,8,10.202020202020202,1108,123.11111111111111,1
1,0,683,517,2,1.3185328185328185,1200,400.0,0
1,3,922,523,35,1.7595419847328244,1445,40.138888888888886,0
1,2,1133,768,48,1.4733420026007802,1901,38.795918367346935,0
0,1,2158,527,63,4.087121212121212,2685,41.953125,1
1,1,1458,2891,82,0.504149377593361,4349,52.397590361445786,1
0,3,856,275,74,3.101449275362319,1131,15.08,0
1,0,1740,1656,0,1.0500905250452626,3396,3396.0,0
0,2,4336,84,114,51.01176470588236,4420,38.43478260869565,1
1,1,356,736,14,0.4830393487109905,1092,72.8,0
2,0,126,836,65,0.15053763440860216,962,14.575757575757576,0
2,2,1314,1183,17,1.1097972972972974,2497,138.72222222222223,0
0,3,3844,559,16,6.864285714285714,4403,259.0,1
0,1,124,175,0,0.7045454545454546,299,299.0,0
1,3,565,368,1,1.5311653116531165,933,466.5,0
1,3,64,254,33,0.25098039215686274,318,9.352941176470589,0
2,3,1498,434,83,3.44367816091954,1932,23.0,0
1,2,2970,603,7,4.917218543046357,3573,446.625,0
0,3,691,784,2,0.8802547770700637,1475,491.6666666666667,0
0,2,526,1492,7,0.3523107836570663,2018,252.25,0
0,2,2382,1926,7,1.2361183186299949,4308,538.5,0
0,3,143,496,10,0.28772635814889336,639,58.09090909090909,0
0,3,2221,74,2,29.613333333333333,2295,765.0,1
2,0,497,1275,8,0.3894984326018809,1772,196.88888888888889,0
2,1,819,518,76,1.5780346820809248,1337,17.363636363636363,0
0,0,751,632,66,1.1864139020537126,1383,20.64179104477612,0
1,1,957,724,11,1.32,1681,140.08333333333334,0
0,1,2849,881,173,3.2301587301587302,3730,21.436781609195403,0
2,0,3018,1766,10,1.7079796264855687,4784,434.90909090909093,1
0,0,1778,2431,38,0.7310855263157895,4209,107.92307692307692,0
2,1,212,2252,30,0.09409675987572126,2464,79.48387096774194,0
2,1,405,1326,2,0.30519969856819895,1731,577.0,0
0,1,669,1760,12,0.3798977853492334,2429,186.84615384615384,0
0,2,2358,40,90,57.51219512195122,2398,26.35164835164835,0
1,1,735,1512,1,0.48578982154659617,2247,1123.5,0
2,3,3791,60,5,62.14754098360656,3851,641.8333333333334,1
1,3,4125,1096,106,3.7602552415679127,5221,48.794392523364486,1
0,3,912,148,1,6.120805369127517,1060,530.0,0
2,0,2099,357,17,5.863128491620111,2456,136.44444444444446,0
1,0,7159,162,75,43.920245398773005,7321,96.32894736842105,1
1,0,1895,468,86,4.040511727078891,2363,27.160919540229884,0
1,1,1069,424,116,2.5152941176470587,1493,12.760683760683762,0
0,3,1865,39,19,46.625,1904,95.2,0
0,1,86,1419,2,0.06056338028169014,1505,501.6666666666667,0
0,2,1007,1540,44,0.6534717715768981,2547,56.6,0
2,2,244,1239,37,0.1967741935483871,1483,39.026315789473685,0
0,0,123,1505,25,0.08167330677290836,1628,62.61538461538461,0
2,2,2233,1111,65,2.008093525179856,3344,50.666666666666664,0
1,3,1020,2217,72,0.4598737601442741,3237,44.342465753424655,0
1,2,279,687,34,0.4055232558139535,966,27.6,0
0,0,489,699,3,0.6985714285714286,1188,297.0,0
1,1,3622,1572,3,2.302606484424666,5194,1298.5,1
0,2,1981,343,15,5.758720930232558,2324,145.25,0
2,3,15,41,10,0.35714285714285715,56,5.090909090909091,0
1,3,3902,1108,4,3.5184851217312896,5010,1002.0,0
0,3,459,235,28,1.944915254237288,694,23.93103448275862,0
1,1,1188,514,34,2.3067961165048545,1702,48.628571428571426,0
1,3,1247,220,35,5.642533936651584,1467,40.75,0
0,0,2426,1403,5,1.727920227920228,3829,638.1666666666666,0
1,0,2163,2541,10,0.8509047993705744,4704,427.6363636363636,0
1,3,330,45,6,7.173913043478261,375,53.57142857142857,0
1,2,1031,212,27,4.84037558685446,1243,44.392857142857146,0
1,3,500,168,25,2.9585798816568047,668,25.692307692307693,0
2,0,745,894,20,0.8324022346368715,1639,78.04761904761905,0
1,0,808,447,10,1.8035714285714286,1255,114.0909090909091,0
1,0,504,487,8,1.0327868852459017,991,110.11111111111111,0
0,2,623,136,66,4.547445255474453,759,11.328358208955224,1
2,2,233,428,1,0.5431235431235432,661,330.5,0
0,2,935,289,32,3.2241379310344827,1224,37.09090909090909,0
0,0,1422,755,0,1.880952380952381,2177,2177.0,1
0,1,561,195,6,2.8622448979591835,756,108.0,0
2,3,3802,763,10,4.976439790575916,4565,415.0,0
0,3,58,379,65,0.15263157894736842,437,6.621212121212121,0
0,0,889,340,4,2.6070381231671553,1229,245.8,0
0,2,876,291,83,3.0,1167,13.892857142857142,0
1,1,36,896,50,0.04013377926421405,932,18.274509803921568,0
0,1,254,661,34,0.38368580060422963,915,26.142857142857142,0
2,2,2359,1526,15,1.5448592010478062,3885,242.8125,0
2,3,786,221,70,3.5405405405405403,1007,14.183098591549296,0
1,3,573,32,22,17.363636363636363,605,26.304347826086957,0
2,1,536,160,13,3.329192546583851,696,49.714285714285715,1
2,1,2190,336,26,6.498516320474778,2526,93.55555555555556,0
1,2,457,158,7,2.8742138364779874,615,76.875,0
0,3,1960,69,9,28.0,2029,202.9,0
1,1,369,471,75,0.7817796610169492,840,11.052631578947368,0
0,3,758,903,47,0.838495575221239,1661,34.604166666666664,0
0,1,155,1114,21,0.13901345291479822,1269,57.68181818181818,0
2,2,1743,406,16,4.282555282555283,2149,126.41176470588235,0
1,3,1331,520,49,2.5547024952015356,1851,37.02,0
2,1,755,1126,25,0.6699201419698314,1881,72.34615384615384,0
2,1,26,347,16,0.07471264367816093,373,21.941176470588236,0
0,1,656,1228,21,0.5337672904800651,1884,85.63636363636364,0
2,1,255,2738,7,0.09309967141292443,2993,374.125,0
1,2,533,1699,6,0.3135294117647059,2232,318.85714285714283,0
2,3,1940,483,135,4.008264462809917,2423,17.816176470588236,1
2,3,1467,693,104,2.1138328530259365,2160,20.571428571428573,0
0,0,277,1008,16,0.2745292368681863,1285,75.58823529411765,0
1,3,4196,343,21,12.19767441860465,4539,206.3181818181818,0
2,0,2335,1284,52,1.8171206225680934,3619,68.28301886792453,0
0,1,752,459,38,1.6347826086956523,1211,31.05128205128205,0
2,2,755,1501,3,0.5026631158455392,2256,564.0,0
1,2,2315,235,14,9.809322033898304,2550,170.0,0
2,1,1010,9,8,101.0,1019,113.22222222222223,0
2,0,769,801,147,0.9588528678304239,1570,10.608108108108109,0
0,1,1382,481,41,2.867219917012448,1863,44.357142857142854,0
2,2,268,49,1,5.36,317,158.5,0
0,2,2106,534,69,3.9364485981308412,2640,37.714285714285715,1
1,3,758,147,78,5.121621621621622,905,11.455696202531646,0
2,0,925,794,12,1.1635220125786163,1719,132.23076923076923,0
1,3,94,471,30,0.19915254237288135,565,18.225806451612904,0
1,2,370,150,34,2.4503311258278146,520,14.857142857142858,0
2,2,556,424,39,1.3082352941176472,980,24.5,0
0,3,534,211,35,2.518867924528302,745,20.694444444444443,0
1,3,1506,846,24,1.7780401416765053,2352,94.08,0
1,2,331,279,92,1.1821428571428572,610,6.559139784946237,0
2,3,201,1380,21,0.14554670528602462,1581,71.86363636363636,0
2,3,873,11,3,72.75,884,221.0,1
2,0,954,413,2,2.3043478260869565,1367,455.6666666666667,0
2,2,129,767,0,0.16796875,896,896.0,0
2,1,2,18,16,0.10526315789473684,20,1.1764705882352942,0
2,0,2496,194,9,12.8,2690,269.0,0
0,1,82,317,67,0.2578616352201258,399,5.867647058823529,0
1,3,2281,17,60,126.72222222222223,2298,37.67213114754098,0
0,3,509,632,54,0.8041074249605056,1141,20.745454545454546,0
0,1,1058,797,60,1.3258145363408522,1855,30.40983606557377,0
2,3,205,206,10,0.9903381642512077,411,37.36363636363637,0
1,3,1736,627,16,2.7643312101910826,2363,139.0,0
0,0,198,5634,11,0.03513753327417923,5832,486.0,0
2,1,488,1743,2,0.2798165137614679,2231,743.6666666666666,0
2,0,271,48,77,5.530612244897959,319,4.089743589743589,0
1,1,1817,109,28,16.51818181818182,1926,66.41379310344827,0
0,0,1954,545,4,3.578754578754579,2499,499.8,0
0,2,465,225,6,2.0575221238938055,690,98.57142857142857,0
0,2,367,67,17,5.397058823529412,434,24.11111111111111,1
2,1,1485,235,1,6.2923728813559325,1720,860.0,0
1,2,2107,50,9,41.31372549019608,2157,215.7,0
1,0,978,603,36,1.619205298013245,1581,42.729729729729726,0
0,1,2622,539,75,4.855555555555555,3161,41.5921052631579,0
2,2,482,5,79,80.33333333333333,487,6.0875,0
0,2,164,527,22,0.3106060606060606,691,30.043478260869566,0
1,1,198,586,11,0.3373083475298126,784,65.33333333333333,0
2,2,1108,744,76,1.487248322147651,1852,24.051948051948052,0
0,2,523,2807,46,0.18625356125356127,3330,70.85106382978724,0
0,1,169,3245,26,0.05206407886629698,3414,126.44444444444444,0
2,2,345,598,53,0.5759599332220368,943,17.462962962962962,0
1,2,756,1492,18,0.506363027461487,2248,118.3157894736842,0
2,2,129,71,3,1.7916666666666667,200,50.0,0
0,2,3,605,83,0.0049504950495049506,608,7.238095238095238,0
0,3,2492,908,22,2.7414741474147415,3400,147.82608695652175,0
0,1,363,665,35,0.545045045045045,1028,28.555555555555557,0
0,3,250,209,14,1.1904761904761905,459,30.6,0
1,3,1198,51,4,23.03846153846154,1249,249.8,1
1,0,1920,391,9,4.8979591836734695,2311,231.1,0
0,3,1000,834,1,1.1976047904191616,1834,917.0,0
1,3,293,3834,2,0.07640156453715775,4127,1375.6666666666667,0
1,0,1977,215,6,9.152777777777779,2192,313.14285714285717,0
1,2,714,1998,24,0.3571785892946473,2712,108.48,0
0,2,479,56,148,8.403508771929825,535,3.5906040268456376,0
2,3,928,2138,55,0.43384759233286585,3066,54.75,0
2,0,1206,1428,2,0.8439468159552135,2634,878.0,0
2,2,900,16,55,52.94117647058823,916,16.357142857142858,0
0,0,2528,283,23,8.901408450704226,2811,117.125,0
1,1,988,41,32,23.523809523809526,1029,31.181818181818183,0
1,1,2108,4323,4,0.48751156336725254,6431,1286.2,0
0,1,884,446,15,1.9776286353467563,1330,83.125,0
0,1,399,868,64,0.45914844649021863,1267,19.49230769230769,0
2,3,759,213,16,3.546728971962617,972,57.1764705882353,0
2,1,90,2171,4,0.04143646408839779,2261,452.2,0
0,1,261,256,11,1.0155642023346303,517,43.083333333333336,0
2,0,1453,241,7,6.0041322314049586,1694,211.75,0
1,2,1083,302,34,3.5742574257425743,1385,39.57142857142857,1
0,0,182,496,72,0.36619718309859156,678,9.287671232876713,0
0,3,576,14,39,38.4,590,14.75,0
1,1,153,728,55,0.20987654320987653,881,15.732142857142858,0
1,2,1936,25,49,74.46153846153847,1961,39.22,0
1,2,115,619,0,0.18548387096774194,734,734.0,0
2,1,1061,489,3,2.1653061224489796,1550,387.5,0
0,1,933,222,16,4.183856502242152,1155,67.94117647058823,1
2,3,640,320,3,1.9937694704049844,960,240.0,0
1,3,326,978,39,0.33299284984678246,1304,32.6,0
2,1,517,7,2,64.625,524,174.66666666666666,0
1,1,1641,304,16,5.380327868852459,1945,114.41176470588235,1
2,1,1433,912,14,1.5695509309967142,2345,156.33333333333334,0
2,1,1342,132,23,10.090225563909774,1474,61.416666666666664,0
1,2,1385,657,29,2.1048632218844983,2042,68.06666666666666,0
2,3,155,148,88,1.0402684563758389,303,3.404494382022472,0
0,1,104,134,9,0.7703703703703704,238,23.8,0
2,1,1976,1183,32,1.6689189189189189,3159,95.72727272727273,0
2,2,1815,247,1,7.318548387096774,2062,1031.0,0
0,0,1143,376,0,3.0318302387267906,1519,1519.0,1
1,1,931,1047,0,0.8883587786259542,1978,1978.0,0
0,2,457,158,17,2.8742138364779874,615,34.166666666666664,0
2,2,253,606,24,0.41680395387149916,859,34.36,0
1,0,1101,1999,0,0.5505,3100,3100.0,0
2,3,2442,645,15,3.780185758513932,3087,192.9375,0
2,3,574,40,1,14.0,614,307.0,0
0,3,361,712,31,0.5063113604488079,1073,33.53125,0
0,1,315,75,29,4.144736842105263,390,13.0,0
1,3,23,265,45,0.08646616541353383,288,6.260869565217392,0
1,1,734,1515,23,0.4841688654353562,2249,93.70833333333333,0
1,1,4442,8,29,493.55555555555554,4450,148.33333333333334,1
2,2,1688,64,9,25.96923076923077,1752,175.2,0
0,3,2277,361,2,6.290055248618785,2638,879.3333333333334,0
0,3,970,5929,40,0.163575042158516,6899,168.26829268292684,0
0,3,656,276,28,2.368231046931408,932,32.13793103448276,0
1,1,4651,136,83,33.948905109489054,4787,56.98809523809524,1
0,1,592,637,135,0.9278996865203761,1229,9.036764705882353,0
0,3,2486,585,56,4.242320819112628,3071,53.87719298245614,1
0,1,1434,477,127,3.0,1911,14.9296875,0
1,1,401,2344,31,0.17100213219616206,2745,85.78125,0
0,0,699,262,2,2.6577946768060836,961,320.3333333333333,0
1,0,485,277,2,1.7446043165467626,762,254.0,0
0,3,146,120,49,1.2066115702479339,266,5.32,0
0,3,441,955,8,0.46129707112970714,1396,155.11111111111111,0
0,0,2197,310,1,7.064308681672026,2507,1253.5,0
1,1,1396,1298,19,1.0746728252501925,2694,134.7,0
1,1,325,2853,11,0.11387526278906797,3178,264.8333333333333,0
0,2,458,35,26,12.722222222222221,493,18.25925925925926,1
2,3,958,3983,27,0.24046184738955823,4941,176.46428571428572,1
1,3,538,234,34,2.2893617021276595,772,22.057142857142857,0
1,3,699,435,25,1.603211009174312,1134,43.61538461538461,0
0,2,1197,1203,14,0.9941860465116279,2400,160.0,0
2,2,629,875,0,0.7180365296803652,1504,1504.0,0
0,1,211,1205,70,0.17495854063018243,1416,19.943661971830984,0
1,0,735,502,11,1.4612326043737573,1237,103.08333333333333,0
1,0,440,1982,21,0.22188603126575895,2422,110.0909090909091,0
0,0,343,1248,24,0.2746196957566053,1591,63.64,0
0,1,397,295,11,1.3412162162162162,692,57.666666666666664,0
2,0,578,2372,11,0.24357353560893383,2950,245.83333333333334,0
2,2,2176,2596,9,0.8378898729303041,4772,477.2,0
1,2,1324,428,8,3.086247086247086,1752,194.66666666666666,0
2,3,1102,844,0,1.3041420118343194,1946,1946.0,0
2,0,637,1348,95,0.47220163083765754,1985,20.677083333333332,0
1,2,1,1359,27,0.0007352941176470588,1360,48.57142857142857,0
1,3,416,11,3,34.666666666666664,427,106.75,0
1,0,1677,793,26,2.1120906801007555,2470,91.48148148148148,0
1,0,491,2910,7,0.16867055994503607,3401,425.125,0
0,2,829,210,11,3.928909952606635,1039,86.58333333333333,1
1,3,229,1270,48,0.18017309205350118,1499,30.591836734693878,0
1,3,2475,611,65,4.044117647058823,3086,46.75757575757576,0
1,2,2566,200,36,12.766169154228855,2766,74.75675675675676,1
2,2,157,41,80,3.738095238095238,198,2.4444444444444446,0
1,2,1287,1141,70,1.1269702276707532,2428,34.19718309859155,0
0,0,78,304,24,0.25573770491803277,382,15.28,0
0,2,912,376,71,2.419098143236074,1288,17.88888888888889,0
1,2,196,531,23,0.3684210526315789,727,30.291666666666668,0
0,1,157,566,3,0.2768959435626102,723,180.75,0
2,2,4,184,53,0.021621621621621623,188,3.4814814814814814,0
1,2,2827,888,4,3.1799775028121484,3715,743.0,0
0,0,1767,943,11,1.8718220338983051,2710,225.83333333333334,0
0,3,80,122,14,0.6504065040650406,202,13.466666666666667,0
1,0,914,608,49,1.5008210180623973,1522,30.44,0
0,1,265,751,2,0.3523936170212766,1016,338.6666666666667,0
1,2,306,164,17,1.8545454545454545,470,26.11111111111111,0
0,2,2072,1798,17,1.1517509727626458,3870,215.0,0
2,2,121,527,26,0.22916666666666666,648,24.0,0
0,2,920,97,13,9.387755102040817,1017,72.64285714285714,1
0,2,512,325,25,1.5705521472392638,837,32.19230769230769,0
1,2,211,518,127,0.40655105973025046,729,5.6953125,0
0,1,601,8,2,66.77777777777777,609,203.0,0
1,2,2821,25,62,108.5,2846,45.17460317460318,0
2,2,1521,45,11,33.06521739130435,1566,130.5,0
1,2,141,617,18,0.22815533980582525,758,39.89473684210526,0
1,1,1893,327,40,5.771341463414634,2220,54.146341463414636,1
0,2,2771,1788,72,1.548910005589715,4559,62.45205479452055,0
2,1,324,655,0,0.49390243902439024,979,979.0,0
1,0,405,1141,32,0.35464098073555167,1546,46.84848484848485,0
0,2,135,929,2,0.14516129032258066,1064,354.6666666666667,0
0,3,423,587,22,0.7193877551020408,1010,43.91304347826087,0
1,1,1118,1092,41,1.0228728270814273,2210,52.61904761904762,0
0,0,317,629,5,0.5031746031746032,946,157.66666666666666,0
1,1,6,389,43,0.015384615384615385,395,8.977272727272727,0
1,1,413,457,11,0.9017467248908297,870,72.5,0
1,0,603,1458,28,0.4132967786154901,2061,71.06896551724138,0
2,2,835,662,32,1.2594268476621417,1497,45.36363636363637,0
1,2,1151,378,31,3.0369393139841687,1529,47.78125,0
0,1,63,158,0,0.39622641509433965,221,221.0,0
2,0,634,547,4,1.1569343065693432,1181,236.2,0
0,2,309,232,58,1.3261802575107295,541,9.169491525423728,0
2,1,2955,2491,84,1.1857945425361156,5446,64.07058823529412,0
2,3,446,540,24,0.8243992606284658,986,39.44,0
2,0,105,7,27,13.125,112,4.0,0
2,3,42,77,42,0.5384615384615384,119,2.7674418604651163,0
0,3,308,267,15,1.1492537313432836,575,35.9375,0
1,1,197,77,11,2.5256410256410255,274,22.833333333333332,0
0,0,1049,1795,43,0.5840757238307349,2844,64.63636363636364,0
1,2,1877,1541,0,1.2172503242542152,3418,3418.0,0
0,2,374,2828,64,0.13220219158713326,3202,49.261538461538464,0
2,1,862,980,17,0.8786952089704383,1842,102.33333333333333,0
2,2,1310,829,21,1.5783132530120483,2139,97.22727272727273,0
1,2,508,2056,30,0.24696159455517744,2564,82.70967741935483,0
1,3,68,2340,9,0.029047415634344296,2408,240.8,0
0,3,260,1679,27,0.15476190476190477,1939,69.25,0
1,0,2146,1581,35,1.3565107458912768,3727,103.52777777777777,0
0,3,1740,891,3,1.9506726457399104,2631,657.75,0
1,2,90,1,22,45.0,91,3.9565217391304346,1
1,0,253,449,11,0.5622222222222222,702,58.5,0
1,0,1466,807,24,1.8143564356435644,2273,90.92,0
2,1,665,633,0,1.0488958990536277,1298,1298.0,0
2,3,1426,1376,40,1.0355846042120551,2802,68.34146341463415,0
0,0,237,1366,5,0.1733723482077542,1603,267.1666666666667,0
1,2,3051,730,35,4.173734610123119,3781,105.02777777777777,1
0,0,1530,17,43,85.0,1547,35.15909090909091,1
1,0,219,368,41,0.5934959349593496,587,13.976190476190476,0
2,1,817,207,51,3.9278846153846154,1024,19.692307692307693,0
2,2,120,330,11,0.36253776435045315,450,37.5,0
1,2,448,768,102,0.5825747724317295,1216,11.805825242718447,0
1,3,1077,55,0,19.232142857142858,1132,1132.0,0
2,2,400,17,19,22.22222222222222,417,20.85,0
2,0,1069,459,9,2.3239130434782607,1528,152.8,0
0,2,280,1262,40,0.22169437846397466,1542,37.609756097560975,0
2,2,1277,24,49,51.08,1301,26.02,1
1,0,445,1512,51,0.29411764705882354,1957,37.63461538461539,0
0,1,1562,387,10,4.025773195876289,1949,177.1818181818182,0
1,3,146,100,9,1.4455445544554455,246,24.6,0
0,3,449,670,33,0.669150521609538,1119,32.911764705882355,0
1,1,623,2435,79,0.2557471264367816,3058,38.225,0
2,0,551,625,8,0.8801916932907349,1176,130.66666666666666,0
1,3,567,928,72,0.6103336921420882,1495,20.47945205479452,0
0,1,588,1356,26,0.4333087693441415,1944,72.0,0
1,1,4492,1284,40,3.4957198443579767,5776,140.8780487804878,0
0,1,214,60,17,3.5081967213114753,274,15.222222222222221,0
1,3,1463,1080,49,1.3533765032377427,2543,50.86,0
2,3,802,2387,105,0.3358458961474037,3189,30.08490566037736,0
2,3,533,964,5,0.5523316062176166,1497,249.5,0
1,3,1003,1448,14,0.6922015182884748,2451,163.4,0
1,2,1920,531,59,3.6090225563909772,2451,40.85,0
1,1,628,307,5,2.038961038961039,935,155.83333333333334,0
0,2,2001,902,15,2.215946843853821,2903,181.4375,0
1,1,98,542,5,0.18047882136279927,640,106.66666666666667,0
1,3,1058,1805,31,0.5858250276854928,2863,89.46875,0
0,3,405,2931,8,0.13813096862210095,3336,370.6666666666667,0
2,2,488,1370,14,0.3559445660102115,1858,123.86666666666666,0
1,0,846,3933,20,0.2150482968988307,4779,227.57142857142858,0
1,3,653,342,10,1.903790087463557,995,90.45454545454545,0
2,0,480,1808,34,0.26533996683250416,2288,65.37142857142857,0
2,1,368,320,3,1.146417445482866,688,172.0,0
0,2,963,100,63,9.534653465346535,1063,16.609375,1
1,0,704,776,19,0.9060489060489061,1480,74.0,0
1,0,390,485,25,0.8024691358024691,875,33.65384615384615,0
0,3,229,2037,29,0.11236506378802748,2266,75.53333333333333,0
2,0,1489,542,1,2.7421731123388584,2031,1015.5,0
0,0,1608,2100,42,0.7653498334126606,3708,86.23255813953489,0
2,1,240,65,87,3.6363636363636362,305,3.465909090909091,0
0,2,303,1419,22,0.21338028169014084,1722,74.8695652173913,0
2,3,273,1138,14,0.23968393327480245,1411,94.06666666666666,0
0,3,2159,1018,46,2.1187438665358194,3177,67.59574468085107,0
2,0,1487,350,38,4.236467236467236,1837,47.1025641025641,0
2,1,77,1225,31,0.06280587275693311,1302,40.6875,0
2,0,1787,528,100,3.3780718336483933,2315,22.92079207920792,1
2,0,37,1004,26,0.03681592039800995,1041,38.55555555555556,0
2,3,291,642,8,0.4525660964230171,933,103.66666666666667,0
1,0,2513,137,0,18.21014492753623,2650,2650.0,1
2,0,1997,53,18,36.98148148148148,2050,107.89473684210526,1
1,1,1520,364,31,4.164383561643835,1884,58.875,0
2,3,611,2159,5,0.2828703703703704,2770,461.6666666666667,0
1,2,387,603,0,0.640728476821192,990,990.0,0
1,1,2133,1296,71,1.6445643793369313,3429,47.625,0
0,1,1070,686,10,1.5574963609898107,1756,159.63636363636363,0
2,1,350,2534,18,0.13806706114398423,2884,151.78947368421052,0
0,3,622,368,2,1.6856368563685638,990,330.0,0
0,0,2132,46,14,45.361702127659576,2178,145.2,0
2,2,2337,1213,16,1.9250411861614498,3550,208.8235294117647,0
0,3,1076,977,69,1.100204498977505,2053,29.32857142857143,0
2,0,1318,599,60,2.1966666666666668,1917,31.42622950819672,0
0,1,40,316,6,0.12618296529968454,356,50.857142857142854,0
2,3,927,166,24,5.550898203592815,1093,43.72,0
2,0,1167,526,39,2.2144212523719164,1693,42.325,0
2,2,20,877,10,0.022779043280182234,897,81.54545454545455,0
1,2,1856,691,15,2.6820809248554913,2547,159.1875,0
0,0,2635,460,125,5.7158351409978305,3095,24.563492063492063,0
1,3,271,620,42,0.4363929146537842,891,20.72093023255814,0
0,1,1869,91,17,20.315217391304348,1960,108.88888888888889,0
0,0,1095,952,22,1.14900314795383,2047,89.0,0
0,1,869,1060,29,0.819038642789821,1929,64.3,0
1,2,1852,9,20,185.2,1861,88.61904761904762,0
0,0,336,252,15,1.3280632411067195,588,36.75,0
1,2,1564,77,13,20.05128205128205,1641,117.21428571428571,1
2,1,377,5070,5,0.07434431078682706,5447,907.8333333333334,0
0,1,1548,719,109,2.15,2267,20.60909090909091,0
0,0,599,501,2,1.1932270916334662,1100,366.6666666666667,0
2,0,124,497,27,0.24899598393574296,621,22.178571428571427,0
2,0,480,2676,96,0.17930519237952933,3156,32.5360824742268,0
0,2,265,862,14,0.3070683661645423,1127,75.13333333333334,0
2,1,105,147,8,0.7094594594594594,252,28.0,0
1,1,116,475,93,0.24369747899159663,591,6.287234042553192,0
1,2,1514,1190,48,1.27120067170445,2704,55.183673469387756,0
0,0,2131,440,31,4.832199546485261,2571,80.34375,0
1,3,2619,296,28,8.818181818181818,2915,100.51724137931035,0
1,0,1923,3787,13,0.5076557550158395,5710,407.85714285714283,0
0,3,1773,2194,30,0.8077448747152619,3967,127.96774193548387,0
2,3,71,2271,38,0.03125,2342,60.05128205128205,0
0,2,1561,112,0,13.814159292035399,1673,1673.0,1
1,1,1529,213,3,7.144859813084112,1742,435.5,0
0,1,140,466,11,0.29978586723768735,606,50.5,0
0,1,1084,1427,11,0.7591036414565826,2511,209.25,0
1,1,602,1067,69,0.5636704119850188,1669,23.84285714285714,0
1,2,2302,1515,34,1.5184696569920844,3817,109.05714285714286,0
0,3,1188,2028,14,0.5855101034992607,3216,214.4,0
1,1,3015,1214,49,2.4814814814814814,4229,84.58,0
1,3,110,242,11,0.45267489711934156,352,29.333333333333332,0
1,2,41,268,140,0.1524163568773234,309,2.1914893617021276,0
1,0,3633,347,45,10.439655172413794,3980,86.52173913043478,1
1,2,83,288,49,0.28719723183391005,371,7.42,0
1,1,488,229,9,2.121739130434783,717,71.7,0
2,0,1049,1117,4,0.9382826475849732,2166,433.2,0
0,2,2120,27,14,75.71428571428571,2147,143.13333333333333,1
1,2,293,1042,12,0.2809204218600192,1335,102.6923076923077,0
0,3,29,1387,44,0.02089337175792507,1416,31.466666666666665,0
2,2,736,54,5,13.381818181818181,790,131.66666666666666,0
1,0,636,51,22,12.23076923076923,687,29.869565217391305,1
0,2,366,268,29,1.3605947955390334,634,21.133333333333333,0
1,1,2070,186,14,11.06951871657754,2256,150.4,0
1,3,1383,696,6,1.9842180774748923,2079,297.0,0
1,0,1952,900,67,2.1664816870144286,2852,41.94117647058823,0
1,0,176,804,4,0.2186335403726708,980,196.0,0
1,2,1178,353,10,3.327683615819209,1531,139.1818181818182,0
1,1,3692,551,42,6.688405797101449,4243,98.67441860465117,0
1,3,946,817,27,1.156479217603912,1763,62.964285714285715,0
2,0,187,101,39,1.8333333333333333,288,7.2,0
2,3,5468,208,49,26.16267942583732,5676,113.52,1
1,2,751,1769,67,0.4242937853107345,2520,37.05882352941177,0
1,1,1832,335,10,5.4523809523809526,2167,197.0,1
2,2,161,1292,19,0.12451662799690642,1453,72.65,0
2,3,1096,231,34,4.724137931034483,1327,37.91428571428571,0
2,2,2437,34,47,69.62857142857143,2471,51.479166666666664,0
1,3,759,555,25,1.3651079136690647,1314,50.53846153846154,0
0,0,340,1784,21,0.19047619047619047,2124,96.54545454545455,0
0,0,136,1368,35,0.09934258582907232,1504,41.77777777777778,0
0,2,350,233,14,1.4957264957264957,583,38.86666666666667,0
0,0,438,1925,67,0.22741433021806853,2363,34.75,0
1,3,1237,522,7,2.3652007648183555,1759,219.875,0
0,0,196,40,64,4.780487804878049,236,3.6307692307692307,1
2,1,112,22,30,4.869565217391305,134,4.32258064516129,0
2,1,489,531,27,0.9191729323308271,1020,36.42857142857143,0
0,2,613,632,19,0.9684044233807267,1245,62.25,0
2,2,989,66,5,14.761194029850746,1055,175.83333333333334,0
1,2,1229,2043,60,0.6012720156555773,3272,53.63934426229508,0
0,2,2200,1013,1,2.1696252465483234,3213,1606.5,0
0,3,341,1292,9,0.2637277648878577,1633,163.3,0
1,3,752,701,3,1.0712250712250713,1453,363.25,0
2,1,455,871,3,0.5217889908256881,1326,331.5,0
1,3,1,392,14,0.002544529262086514,393,26.2,0
1,0,866,909,5,0.9516483516483516,1775,295.8333333333333,0
2,1,1691,3060,26,0.5524338451486442,4751,175.96296296296296,1
1,2,37,834,29,0.04431137724550898,871,29.033333333333335,0
2,2,3,334,64,0.008955223880597015,337,5.184615384615385,0
2,3,1301,268,10,4.836431226765799,1569,142.63636363636363,0
1,1,1151,2644,11,0.43516068052930057,3795,316.25,0
2,3,520,163,8,3.1707317073170733,683,75.88888888888889,0
1,3,1083,1312,45,0.8248286367098249,2395,52.06521739130435,0
2,3,3065,500,16,6.1177644710578845,3565,209.7058823529412,0
0,1,284,469,24,0.6042553191489362,753,30.12,0
2,2,282,1101,14,0.2558983666061706,1383,92.2,0
2,0,206,128,5,1.5968992248062015,334,55.666666666666664,0
1,2,1287,502,3,2.558648111332008,1789,447.25,0
2,1,435,29,60,14.5,464,7.60655737704918,0
0,2,4482,887,9,5.047297297297297,5369,536.9,0
0,2,1254,48,85,25.591836734693878,1302,15.13953488372093,0
2,0,457,73,88,6.175675675675675,530,5.955056179775281,0
2,2,161,1490,19,0.107981220657277,1651,82.55,0
0,2,896,468,95,1.9104477611940298,1364,14.208333333333334,0
1,2,349,179,0,1.9388888888888889,528,528.0,0
0,3,2359,718,2,3.2809457579972183,3077,1025.6666666666667,0
0,1,582,585,8,0.9931740614334471,1167,129.66666666666666,0
2,1,346,423,7,0.8160377358490566,769,96.125,0
2,0,888,1886,8,0.47058823529411764,2774,308.22222222222223,0
0,3,147,1107,18,0.13267148014440433,1254,66.0,0
1,3,824,131,1,6.242424242424242,955,477.5,1
0,2,57,676,24,0.08419497784342689,733,29.32,0
0,1,933,74,11,12.44,1007,83.91666666666667,1
1,0,755,224,2,3.3555555555555556,979,326.3333333333333,0
0,3,735,1925,41,0.38161993769470404,2660,63.333333333333336,0
0,2,1152,496,31,2.317907444668008,1648,51.5,0
2,0,45,1781,47,0.025252525252525252,1826,38.041666666666664,0
1,3,615,145,84,4.212328767123288,760,8.941176470588236,1
2,0,587,183,26,3.1902173913043477,770,28.51851851851852,0
2,3,615,348,46,1.7621776504297995,963,20.48936170212766,0
1,0,3906,364,6,10.7013698630137,4270,610.0,1
1,3,149,1094,15,0.13607305936073058,1243,77.6875,0
0,3,1172,731,22,1.6010928961748634,1903,82.73913043478261,0
2,0,514,644,23,0.7968992248062016,1158,48.25,0
1,3,716,737,38,0.9701897018970189,1453,37.256410256410255,0
2,3,1437,1053,47,1.3633776091081593,2490,51.875,0
2,3,171,1786,32,0.09569110240626749,1957,59.303030303030305,0
1,0,1442,428,1,3.3613053613053614,1870,935.0,0
0,0,72,1299,12,0.055384615384615386,1371,105.46153846153847,0
2,3,660,546,25,1.206581352833638,1206,46.38461538461539,0
1,3,1355,1024,21,1.3219512195121952,2379,108.13636363636364,0
0,0,213,1662,1,0.1280817799158148,1875,937.5,0
2,2,1473,26,118,54.55555555555556,1499,12.596638655462185,0
1,3,182,632,93,0.28751974723538704,814,8.659574468085106,0
2,2,1605,3636,44,0.4412977728897443,5241,116.46666666666667,1
1,0,632,548,1,1.151183970856102,1180,590.0,0
1,3,1154,1597,16,0.7221526908635795,2751,161.8235294117647,0
2,2,2493,164,15,15.10909090909091,2657,166.0625,0
2,0,524,741,24,0.706199460916442,1265,50.6,0
1,2,265,1634,1,0.1620795107033639,1899,949.5,0
0,1,2018,451,16,4.464601769911504,2469,145.23529411764707,1
2,0,176,533,42,0.3295880149812734,709,16.488372093023255,0
1,1,998,68,186,14.46376811594203,1066,5.7005347593582885,0
1,0,2567,34,27,73.34285714285714,2601,92.89285714285714,1
0,0,1122,505,84,2.217391304347826,1627,19.141176470588235,0
0,3,217,1483,195,0.14622641509433962,1700,8.673469387755102,0
0,1,165,2142,17,0.07699486700886607,2307,128.16666666666666,0
2,1,290,859,33,0.3372093023255814,1149,33.794117647058826,0
1,1,496,1400,7,0.35403283369022126,1896,237.0,0
1,0,173,1061,19,0.16290018832391714,1234,61.7,0
1,1,1598,967,2,1.6508264462809918,2565,855.0,0
0,1,441,1172,0,0.37595907928388744,1613,1613.0,0
1,3,2750,563,67,4.875886524822695,3313,48.720588235294116,0
2,2,1848,489,58,3.7714285714285714,2337,39.610169491525426,1
0,2,2394,138,11,17.223021582733814,2532,211.0,0
0,1,348,1485,18,0.23418573351278602,1833,96.47368421052632,0
0,1,852,36,20,23.027027027027028,888,42.285714285714285,0
0,1,387,248,22,1.5542168674698795,635,27.608695652173914,0
2,1,296,587,4,0.5034013605442177,883,176.6,0
1,2,934,2849,44,0.327719298245614,3783,84.06666666666666,0
2,3,1703,1233,12,1.380064829821718,2936,225.84615384615384,0
1,0,98,367,0,0.266304347826087,465,465.0,0
2,1,322,1001,33,0.3213572854291417,1323,38.911764705882355,0
0,1,229,2143,53,0.10680970149253731,2372,43.925925925925924,0
0,2,1601,619,75,2.582258064516129,2220,29.210526315789473,0
2,1,2708,495,33,5.459677419354839,3203,94.20588235294117,0
2,3,83,644,6,0.12868217054263567,727,103.85714285714286,0
1,3,476,298,26,1.5919732441471572,774,28.666666666666668,0
2,1,2459,1903,72,1.2914915966386555,4362,59.75342465753425,1
2,2,422,1276,12,0.33046202036021927,1698,130.6153846153846,0
1,1,1247,977,91,1.2750511247443763,2224,24.17391304347826,0
1,1,106,711,3,0.14887640449438203,817,204.25,0
1,2,587,2791,39,0.21024355300859598,3378,84.45,0
2,3,699,282,3,2.469964664310954,981,245.25,0
1,0,1417,266,48,5.307116104868914,1683,34.3469387755102,0
0,1,340,221,3,1.5315315315315314,561,140.25,0
0,3,306,1083,11,0.2822878228782288,1389,115.75,0
0,1,360,1276,44,0.28191072826938135,1636,36.355555555555554,0
2,0,811,727,18,1.114010989010989,1538,80.94736842105263,0
0,2,2087,844,64,2.4698224852071005,2931,45.09230769230769,0
2,3,1777,343,15,5.165697674418604,2120,132.5,0
2,0,59,32,158,1.7878787878787878,91,0.5723270440251572,0
0,1,2111,234,0,8.982978723404255,2345,2345.0,0
1,0,99,702,35,0.14082503556187767,801,22.25,0
2,3,536,1341,74,0.39940387481371087,1877,25.026666666666667,0
0,2,1449,1201,23,1.2054908485856906,2650,110.41666666666667,0
2,1,85,158,133,0.5345911949685535,243,1.8134328358208955,0
1,2,41,42,36,0.9534883720930233,83,2.2432432432432434,0
1,2,400,1520,16,0.26298487836949375,1920,112.94117647058823,0
0,0,1309,62,21,20.77777777777778,1371,62.31818181818182,1
2,0,737,399,62,1.8425,1136,18.03174603174603,0
2,3,539,79,94,6.7375,618,6.505263157894737,1
2,3,1677,664,24,2.5218045112781953,2341,93.64,0
2,2,1455,361,11,4.019337016574585,1816,151.33333333333334,0
0,3,1541,181,8,8.467032967032967,1722,191.33333333333334,0
1,2,615,723,19,0.8494475138121547,1338,66.9,0
0,1,19,361,10,0.052486187845303865,380,34.54545454545455,0
2,2,188,145,16,1.2876712328767124,333,19.58823529411765,0
2,3,1352,963,53,1.4024896265560165,2315,42.870370370370374,0
1,3,1399,1450,19,0.9641626464507237,2849,142.45,0
2,2,3586,255,30,14.0078125,3841,123.90322580645162,0
0,0,210,165,2,1.2650602409638554,375,125.0,0
0,2,131,62,43,2.0793650793650795,193,4.386363636363637,0
1,2,149,600,19,0.24792013311148087,749,37.45,0
0,0,204,1423,13,0.14325842696629212,1627,116.21428571428571,0
0,1,751,230,28,3.2510822510822512,981,33.827586206896555,1
0,0,3697,493,3,7.483805668016195,4190,1047.5,0
0,3,890,140,16,6.3120567375886525,1030,60.588235294117645,0
2,0,739,414,49,1.780722891566265,1153,23.06,0
0,3,1118,12,9,86.0,1130,113.0,0
1,3,76,1932,73,0.03931712364200724,2008,27.135135135135137,0
1,2,1689,903,27,1.8683628318584071,2592,92.57142857142857,0
0,2,1040,323,23,3.2098765432098766,1363,56.791666666666664,0
1,1,187,1704,15,0.10967741935483871,1891,118.1875,0
0,3,996,161,40,6.148148148148148,1157,28.21951219512195,0
1,2,906,65,24,13.727272727272727,971,38.84,0
1,3,67,2286,47,0.02929602098819414,2353,49.020833333333336,0
0,1,310,295,12,1.0472972972972974,605,46.53846153846154,0
0,3,495,2198,36,0.22510231923601637,2693,72.78378378378379,0
2,1,280,812,86,0.34440344403444034,1092,12.551724137931034,0
0,1,278,3131,9,0.08876117496807152,3409,340.9,0
0,1,850,1120,118,0.7582515611061552,1970,16.554621848739497,0
2,2,636,89,15,7.066666666666666,725,45.3125,0
0,0,1100,1529,1,0.7189542483660131,2629,1314.5,0
0,0,3132,128,13,24.27906976744186,3260,232.85714285714286,1
2,2,1080,942,4,1.1452810180275717,2022,404.4,0
0,3,872,555,10,1.5683453237410072,1427,129.72727272727272,0
0,2,1880,984,3,1.9086294416243654,2864,716.0,0
2,3,999,1158,5,0.8619499568593615,2157,359.5,0
2,1,180,1302,4,0.13814274750575595,1482,296.4,0
1,2,377,1441,1,0.26144244105409153,1818,909.0,0
0,0,1321,1503,10,0.8783244680851063,2824,256.72727272727275,0
1,3,1340,425,84,3.1455399061032865,1765,20.764705882352942,1
1,2,4343,1760,89,2.466212379329926,6103,67.81111111111112,0
2,2,986,1017,56,0.9685658153241651,2003,35.14035087719298,0
0,3,2298,1460,0,1.5728952772073923,3758,3758.0,0
0,1,56,3621,0,0.015461071231363888,3677,3677.0,0
2,1,835,99,0,8.35,934,934.0,0
1,1,2523,370,13,6.800539083557951,2893,206.64285714285714,0
2,1,338,1314,117,0.2570342205323194,1652,14.0,0
0,3,168,72,68,2.3013698630136985,240,3.4782608695652173,0
2,0,431,622,8,0.6918138041733547,1053,117.0,0
0,2,1571,1563,15,1.0044757033248082,3134,195.875,0
1,2,88,15,52,5.5,103,1.9433962264150944,1
0,1,917,2244,42,0.4084632516703786,3161,73.51162790697674,0
1,3,145,3058,4,0.047401111474338016,3203,640.6,0
1,0,571,311,3,1.830128205128205,882,220.5,0
0,0,3380,1164,23,2.9012875536480687,4544,189.33333333333334,1
0,2,217,108,3,1.9908256880733946,325,81.25,0
1,1,34,1185,52,0.02866779089376054,1219,23.0,0
2,2,557,525,8,1.05893536121673,1082,120.22222222222223,0
0,2,862,1574,6,0.5473015873015873,2436,348.0,0
1,0,353,191,6,1.8385416666666667,544,77.71428571428571,0
1,3,780,893,1,0.87248322147651,1673,836.5,0
2,0,3066,1233,30,2.4846029173419772,4299,138.67741935483872,0
0,2,373,181,5,2.0494505494505493,554,92.33333333333333,0
1,1,370,1364,7,0.27106227106227104,1734,216.75,0
2,1,659,2535,41,0.25985804416403785,3194,76.04761904761905,0
1,3,724,765,1,0.9451697127937336,1489,744.5,0
0,3,1,1229,6,0.0008130081300813008,1230,175.71428571428572,0
2,3,956,608,4,1.5697865353037768,1564,312.8,0
1,2,5935,729,0,8.13013698630137,6664,6664.0,1
2,2,345,10,23,31.363636363636363,355,14.791666666666666,1
0,3,996,594,6,1.6739495798319328,1590,227.14285714285714,0
2,1,4,685,30,0.0058309037900874635,689,22.225806451612904,0
0,1,927,887,20,1.0439189189189189,1814,86.38095238095238,0
1,1,592,148,33,3.9731543624161074,740,21.764705882352942,0
0,2,755,220,119,3.416289592760181,975,8.125,0
1,0,785,1128,7,0.6953055801594331,1913,239.125,0
1,1,194,146,32,1.3197278911564625,340,10.303030303030303,0
0,1,1469,430,53,3.4083526682134573,1899,35.166666666666664,0
1,1,810,230,94,3.5064935064935066,1040,10.947368421052632,1
2,3,314,630,29,0.4976228209191759,944,31.466666666666665,0
1,2,2770,3466,4,0.7989616383040092,6236,1247.2,0
0,3,12,1528,1,0.007848266841072597,1540,770.0,0
2,3,1294,251,9,5.134920634920635,1545,154.5,1
2,0,480,367,78,1.3043478260869565,847,10.721518987341772,0
1,3,739,2007,23,0.36802788844621515,2746,114.41666666666667,0
1,0,344,1828,25,0.18808091853471842,2172,83.53846153846153,0
0,3,387,139,28,2.7642857142857142,526,18.137931034482758,0
2,1,15,1414,12,0.01060070671378092,1429,109.92307692307692,0
0,2,1308,282,6,4.6219081272084805,1590,227.14285714285714,0
1,3,1240,627,92,1.9745222929936306,1867,20.0752688172043,0
2,0,1062,4,42,212.4,1066,24.790697674418606,0
0,2,2103,5251,21,0.4004188880426504,7354,334.27272727272725,0
0,0,2315,1145,14,2.020069808027923,3460,230.66666666666666,0
0,1,812,221,19,3.6576576576576576,1033,51.65,0
0,3,1154,921,1,1.2516268980477223,2075,1037.5,0
0,2,11,277,8,0.039568345323741004,288,32.0,0
2,1,1873,74,8,24.973333333333333,1947,216.33333333333334,0
0,3,1695,443,17,3.8175675675675675,2138,118.77777777777777,0
2,3,20,760,8,0.026281208935611037,780,86.66666666666667,0
0,0,782,75,6,10.289473684210526,857,122.42857142857143,0
1,0,2371,584,43,4.052991452991453,2955,67.1590909090909,1
1,1,200,578,67,0.3454231433506045,778,11.441176470588236,0
0,0,434,792,2,0.5472887767969735,1226,408.6666666666667,0
1,1,402,224,7,1.7866666666666666,626,78.25,0
2,1,439,16,44,25.823529411764707,455,10.11111111111111,0
0,1,42,314,50,0.13333333333333333,356,6.980392156862745,0
2,0,327,406,20,0.8034398034398035,733,34.904761904761905,0
0,2,349,807,35,0.4319306930693069,1156,32.111111111111114,0
1,1,2008,2129,2,0.9427230046948357,4137,1379.0,0
2,2,434,181,56,2.3846153846153846,615,10.789473684210526,0
1,3,592,930,53,0.635875402792696,1522,28.185185185185187,0
1,0,479,81,35,5.841463414634147,560,15.555555555555555,0
0,0,128,169,74,0.7529411764705882,297,3.96,0
2,2,4641,569,1,8.142105263157895,5210,2605.0,1
1,3,1747,985,7,1.7718052738336714,2732,341.5,0
0,3,778,1564,13,0.4971246006389776,2342,167.28571428571428,0
0,1,646,1089,5,0.5926605504587156,1735,289.1666666666667,0
0,0,1047,12,50,80.53846153846153,1059,20.764705882352942,0
1,3,395,921,42,0.4284164859002169,1316,30.6046511627907,0
0,3,51,1392,44,0.0366116295764537,1443,32.06666666666667,0
2,1,518,596,10,0.8676716917922948,1114,101.27272727272727,0
2,1,4133,2695,43,1.5330118694362018,6828,155.1818181818182,0
1,2,201,3,3,50.25,204,51.0,1
2,0,750,1365,3,0.5490483162518301,2115,528.75,0
0,3,8,326,26,0.024464831804281346,334,12.37037037037037,0
1,2,130,840,1,0.1545778834720571,970,485.0,0
0,0,884,945,83,0.9344608879492601,1829,21.773809523809526,0
1,2,352,292,11,1.2013651877133107,644,53.666666666666664,0
1,0,2361,4309,19,0.5477958236658933,6670,333.5,0
0,0,521,87,50,5.920454545454546,608,11.92156862745098,0
2,3,233,136,15,1.7007299270072993,369,23.0625,0
2,0,788,1781,16,0.44219977553310885,2569,151.11764705882354,0
1,1,1584,101,12,15.529411764705882,1685,129.6153846153846,0
0,3,19,384,13,0.04935064935064935,403,28.785714285714285,0
0,1,704,1056,18,0.6660359508041628,1760,92.63157894736842,0
1,2,1484,1254,87,1.1824701195219123,2738,31.113636363636363,0
2,2,109,2475,82,0.04402261712439418,2584,31.132530120481928,0
0,0,2330,1246,23,1.8684843624699279,3576,149.0,0
2,0,307,1489,18,0.20604026845637585,1796,94.52631578947368,0
2,1,187,2386,49,0.07834101382488479,2573,51.46,0
1,1,889,645,34,1.3761609907120742,1534,43.82857142857143,0
1,1,192,336,64,0.56973293768546,528,8.123076923076923,0
2,2,1138,1147,39,0.9912891986062717,2285,57.125,0
0,1,673,142,91,4.706293706293707,815,8.858695652173912,0
0,3,116,56,65,2.0350877192982457,172,2.606060606060606,0
1,3,2436,1230,57,1.9788789601949635,3666,63.206896551724135,0
2,2,1118,2407,14,0.4642857142857143,3525,235.0,0
0,1,789,467,14,1.685897435897436,1256,83.73333333333333,0
0,1,468,140,40,3.3191489361702127,608,14.829268292682928,1
1,0,144,549,2,0.26181818181818184,693,231.0,0
2,3,1229,399,11,3.0725,1628,135.66666666666666,0
0,2,1680,372,80,4.50402144772118,2052,25.333333333333332,0
1,1,134,791,17,0.1691919191919192,925,51.388888888888886,0
0,0,682,153,9,4.428571428571429,835,83.5,0
0,2,663,383,19,1.7265625,1046,52.3,0
0,2,430,1624,10,0.26461538461538464,2054,186.72727272727272,0
1,3,1557,1046,43,1.487106017191977,2603,59.15909090909091,0
2,1,104,45,57,2.260869565217391,149,2.5689655172413794,0
1,2,229,577,45,0.3961937716262976,806,17.52173913043478,0
2,0,1,76,4,0.012987012987012988,77,15.4,0
0,0,466,2526,12,0.184408389394539,2992,230.15384615384616,0
2,2,344,224,7,1.528888888888889,568,71.0,0
0,0,2017,2157,1,0.9346617238183503,4174,2087.0,0
0,2,1369,1436,40,0.9526791927627001,2805,68.41463414634147,0
1,0,88,641,16,0.13707165109034267,729,42.88235294117647,0
0,2,1350,327,9,4.115853658536586,1677,167.7,1
1,2,1125,1561,11,0.7202304737516005,2686,223.83333333333334,0
2,2,330,132,4,2.481203007518797,462,92.4,0
2,0,15,158,52,0.09433962264150944,173,3.2641509433962264,0
0,2,122,203,4,0.5980392156862745,325,65.0,0
1,3,287,728,12,0.3936899862825789,1015,78.07692307692308,0
0,2,1696,301,0,5.6158940397351,1997,1997.0,1
1,1,626,3621,17,0.17283268912203203,4247,235.94444444444446,0
1,1,2505,173,13,14.39655172413793,2678,191.28571428571428,0
1,3,1556,1310,38,1.186880244088482,2866,73.48717948717949,0
2,2,338,80,37,4.172839506172839,418,11.0,0
1,1,1866,348,1,5.346704871060172,2214,1107.0,1
2,2,124,223,3,0.5535714285714286,347,86.75,0
1,1,36,3012,70,0.011948224361101892,3048,42.929577464788736,0
2,0,937,20,47,44.61904761904762,957,19.9375,0
2,0,418,1023,14,0.408203125,1441,96.06666666666666,0
2,3,399,227,5,1.75,626,104.33333333333333,0
0,3,1162,1333,9,0.8710644677661169,2495,249.5,0
1,2,1897,298,32,6.344481605351171,2195,66.51515151515152,1
0,3,388,165,87,2.3373493975903616,553,6.284090909090909,0
1,2,393,944,28,0.4158730158730159,1337,46.10344827586207,0
1,0,763,238,0,3.192468619246862,1001,1001.0,0
0,0,1058,531,31,1.9887218045112782,1589,49.65625,0
2,1,226,112,86,2.0,338,3.8850574712643677,0
1,2,2438,1031,13,2.362403100775194,3469,247.78571428571428,0
2,0,1062,417,81,2.54066985645933,1479,18.036585365853657,0
0,0,981,121,33,8.040983606557377,1102,32.411764705882355,0
2,2,2345,1082,6,2.16528162511542,3427,489.57142857142856,0
1,1,2378,87,4,27.022727272727273,2465,493.0,0
1,1,145,684,5,0.2116788321167883,829,138.16666666666666,0
1,1,156,748,36,0.2082777036048064,904,24.43243243243243,0
0,1,1435,2131,26,0.6730769230769231,3566,132.07407407407408,0
1,0,3143,130,18,23.99236641221374,3273,172.26315789473685,0
0,2,1098,847,9,1.294811320754717,1945,194.5,0
2,2,529,383,71,1.3776041666666667,912,12.666666666666666,0
1,0,1150,409,7,2.8048780487804876,1559,194.875,0
1,0,259,557,10,0.46415770609318996,816,74.18181818181819,0
1,0,6197,213,1,28.957943925233646,6410,3205.0,0
2,3,564,494,9,1.1393939393939394,1058,105.8,0
1,2,2683,928,76,2.8880516684607103,3611,46.896103896103895,0
0,2,563,488,6,1.1513292433537832,1051,150.14285714285714,0
2,2,2633,34,6,75.22857142857143,2667,381.0,0
2,1,408,238,27,1.707112970711297,646,23.071428571428573,0
2,0,1429,346,25,4.118155619596542,1775,68.26923076923077,0
2,0,3015,350,5,8.58974358974359,3365,560.8333333333334,0
2,0,1038,67,5,15.264705882352942,1105,184.16666666666666,0
0,3,1131,477,3,2.3661087866108788,1608,402.0,0
2,2,108,941,59,0.11464968152866242,1049,17.483333333333334,0
1,0,642,39,31,16.05,681,21.28125,1
2,3,2178,1111,92,1.95863309352518,3289,35.365591397849464,0
2,0,275,2482,5,0.11075312122432542,2757,459.5,0
2,1,1552,7,18,194.0,1559,82.05263157894737,0
2,2,1126,172,40,6.508670520231214,1298,31.658536585365855,0
2,3,252,627,7,0.4012738853503185,879,109.875,0
0,0,332,196,34,1.6852791878172588,528,15.085714285714285,0
0,2,557,1157,19,0.48100172711571676,1714,85.7,0
2,3,133,299,16,0.44333333333333336,432,25.41176470588235,0
0,2,2446,278,31,8.767025089605735,2724,85.125,0
1,2,1344,0,18,1344.0,1344,70.73684210526316,0
2,1,454,251,51,1.8015873015873016,705,13.557692307692308,0
1,2,356,196,80,1.8071065989847717,552,6.814814814814815,0
1,3,1169,336,26,3.4688427299703264,1505,55.74074074074074,0
2,2,552,127,10,4.3125,679,61.72727272727273,0
1,3,260,722,45,0.359612724757953,982,21.347826086956523,0
1,2,562,218,5,2.5662100456621006,780,130.0,0
1,0,2050,1425,2,1.4375876577840112,3475,1158.3333333333333,0
2,1,71,267,21,0.26492537313432835,338,15.363636363636363,0
2,0,459,189,31,2.4157894736842107,648,20.25,0
1,1,3279,46,54,69.76595744680851,3325,60.45454545454545,0
2,3,14,1077,93,0.012987012987012988,1091,11.606382978723405,0
2,1,2213,567,61,3.8961267605633805,2780,44.83870967741935,0
1,2,469,96,134,4.835051546391752,565,4.185185185185185,0
2,2,210,200,19,1.044776119402985,410,20.5,0
0,0,15,5328,11,0.00281478701444924,5343,445.25,0
2,1,73,1312,18,0.055597867479055596,1385,72.89473684210526,0
0,3,188,344,30,0.5449275362318841,532,17.161290322580644,0
1,3,25,625,21,0.039936102236421724,650,29.545454545454547,0
2,2,409,430,30,0.9489559164733179,839,27.06451612903226,0
1,3,45,29,65,1.5,74,1.121212121212121,0
1,2,1178,1206,5,0.975973487986744,2384,397.3333333333333,0
1,2,1708,1009,3,1.691089108910891,2717,679.25,0
1,2,2184,420,20,5.1876484560570075,2604,124.0,0
1,0,796,1496,120,0.5317301269205077,2292,18.94214876033058,0
2,0,2928,612,1,4.7765089722675365,3540,1770.0,1
0,2,5,53,129,0.09259259259259259,58,0.4461538461538462,0
2,2,143,240,102,0.5933609958506224,383,3.7184466019417477,0
2,2,346,495,10,0.6975806451612904,841,76.45454545454545,0
2,3,1556,87,66,17.681818181818183,1643,24.52238805970149,0
2,2,2166,677,0,3.1946902654867255,2843,2843.0,1
0,2,962,102,18,9.339805825242719,1064,56.0,0
2,1,483,179,15,2.683333333333333,662,41.375,0
1,1,1096,1795,69,0.6102449888641426,2891,41.3,0
2,1,199,6864,19,0.02898761835396941,7063,353.15,0
2,1,612,639,16,0.95625,1251,73.58823529411765,0
0,2,708,773,30,0.9147286821705426,1481,47.774193548387096,0
0,1,110,1277,14,0.08607198748043818,1387,92.46666666666667,0
1,3,34,952,23,0.035676810073452254,986,41.083333333333336,0
2,3,1386,161,93,8.555555555555555,1547,16.45744680851064,1
2,1,765,424,6,1.8,1189,169.85714285714286,0
2,0,403,612,18,0.6574225122349103,1015,53.421052631578945,0
1,3,574,356,0,1.607843137254902,930,930.0,0
0,3,3163,154,55,20.406451612903226,3317,59.232142857142854,1
1,1,485,1065,2,0.4549718574108818,1550,516.6666666666666,0
2,1,109,177,2,0.6123595505617978,286,95.33333333333333,0
0,2,622,241,64,2.5702479338842976,863,13.276923076923078,0
0,3,1044,270,15,3.8523985239852396,1314,82.125,0
1,1,12,141,34,0.08450704225352113,153,4.371428571428571,0
0,1,403,1515,58,0.2658311345646438,1918,32.50847457627118,0
0,2,500,754,14,0.6622516556291391,1254,83.6,0
2,3,623,1440,9,0.4323386537126995,2063,206.3,0
2,1,359,544,5,0.6587155963302752,903,150.5,0
0,2,1099,586,28,1.8722316865417377,1685,58.10344827586207,0
0,1,2895,765,8,3.779373368146214,3660,406.6666666666667,0
1,0,2453,370,30,6.611859838274933,2823,91.06451612903226,0
1,0,1091,549,11,1.9836363636363636,1640,136.66666666666666,0
0,1,707,633,12,1.115141955835962,1340,103.07692307692308,0
2,3,1747,2455,8,0.7113192182410424,4202,466.8888888888889,0
0,0,1807,1715,16,1.053030303030303,3522,207.1764705882353,0
0,2,1769,110,5,15.936936936936936,1879,313.1666666666667,1
2,1,171,33,11,5.029411764705882,204,17.0,0
2,2,25,912,45,0.027382256297918947,937,20.369565217391305,0
1,0,4085,40,7,99.63414634146342,4125,515.625,1
1,3,3210,49,88,64.2,3259,36.61797752808989,0
1,2,830,138,20,5.971223021582734,968,46.095238095238095,1
1,0,4970,346,3,14.322766570605188,5316,1329.0,1
2,0,1472,456,85,3.2210065645514225,1928,22.41860465116279,0
0,0,728,586,18,1.2402044293015333,1314,69.15789473684211,0
1,2,493,3892,24,0.12663755458515283,4385,175.4,1
1,0,898,389,6,2.3025641025641024,1287,183.85714285714286,0
2,1,725,222,12,3.2511210762331837,947,72.84615384615384,1
2,0,5083,685,36,7.409620991253644,5768,155.8918918918919,0
0,1,674,193,3,3.4742268041237114,867,216.75,0
0,3,1807,2258,25,0.7999114652501107,4065,156.34615384615384,0
2,1,1679,240,35,6.966804979253112,1919,53.30555555555556,0
1,3,74,3678,0,0.02011416145691764,3752,3752.0,0
1,3,91,433,54,0.20967741935483872,524,9.527272727272727,0
1,1,1078,1339,1,0.8044776119402985,2417,1208.5,0
0,3,299,835,8,0.3576555023923445,1134,126.0,0
1,1,1071,2168,99,0.49377593360995853,3239,32.39,0
1,2,156,785,2,0.1984732824427481,941,313.6666666666667,0
2,3,505,696,52,0.7245337159253945,1201,22.660377358490567,0
1,1,108,846,31,0.12750885478158205,954,29.8125,0
2,3,331,1235,27,0.26779935275080907,1566,55.92857142857143,0
1,0,92,1832,26,0.050190943807965085,1924,71.25925925925925,0
0,1,3526,248,5,14.160642570281125,3774,629.0,0
1,0,502,179,33,2.7888888888888888,681,20.029411764705884,0
1,3,2314,27,90,82.64285714285714,2341,25.725274725274726,0
2,3,3546,369,2,9.583783783783783,3915,1305.0,0
2,2,2403,1497,12,1.6041388518024031,3900,300.0,0
2,1,606,57,19,10.448275862068966,663,33.15,1
1,0,1509,618,7,2.4378029079159935,2127,265.875,0
1,2,166,949,40,0.17473684210526316,1115,27.195121951219512,0
0,3,99,1450,35,0.06822880771881461,1549,43.02777777777778,0
1,3,2094,700,3,2.9871611982881596,2794,698.5,0
0,2,31,164,25,0.18787878787878787,195,7.5,0
2,0,3587,2671,13,1.342440119760479,6258,447.0,0
2,3,1115,79,7,13.9375,1194,149.25,0
2,3,544,1172,56,0.463768115942029,1716,30.105263157894736,0
0,1,152,72,1,2.0821917808219177,224,112.0,0
1,2,1284,123,18,10.35483870967742,1407,74.05263157894737,0
2,3,828,1827,19,0.45295404814004375,2655,132.75,0
1,0,1241,1118,25,1.1090259159964253,2359,90.73076923076923,0
1,1,541,363,6,1.4862637362637363,904,129.14285714285714,0
2,2,68,814,61,0.0834355828220859,882,14.225806451612904,0
0,0,378,488,100,0.7730061349693251,866,8.574257425742575,0
1,3,378,55,23,6.75,433,18.041666666666668,1
2,2,8,1021,8,0.007827788649706457,1029,114.33333333333333,0
1,2,9,1152,62,0.007805724197745013,1161,18.428571428571427,0
1,0,401,1711,133,0.23422897196261683,2112,15.761194029850746,0
1,2,1300,622,40,2.086677367576244,1922,46.8780487804878,0
1,0,978,894,12,1.0927374301675978,1872,144.0,0
1,3,273,461,8,0.5909090909090909,734,81.55555555555556,0
0,1,923,307,5,2.9967532467532467,1230,205.0,0
0,0,1042,424,8,2.451764705882353,1466,162.88888888888889,0
2,1,739,1942,7,0.38033968090581577,2681,335.125,0
0,2,736,143,102,5.111111111111111,879,8.533980582524272,1
0,0,461,228,30,2.013100436681223,689,22.225806451612904,0
0,3,131,745,5,0.17560321715817695,876,146.0,0
1,0,486,98,20,4.909090909090909,584,27.80952380952381,0
1,0,423,1779,6,0.23764044943820226,2202,314.57142857142856,0
2,0,896,38,27,22.974358974358974,934,33.357142857142854,0
2,1,1939,1126,12,1.720496894409938,3065,235.76923076923077,0
2,1,470,374,6,1.2533333333333334,844,120.57142857142857,0
1,2,1236,42,8,28.74418604651163,1278,142.0,0
0,2,1670,1480,33,1.1276164753544902,3150,92.6470588235294,0
0,2,237,818,15,0.2893772893772894,1055,65.9375,0
1,2,2319,7,21,289.875,2326,105.72727272727273,0
2,0,73,249,51,0.292,322,6.1923076923076925,0
2,1,2319,347,31,6.663793103448276,2666,83.3125,1
2,1,178,311,18,0.5705128205128205,489,25.736842105263158,0
1,1,411,551,92,0.7445652173913043,962,10.344086021505376,0
2,1,929,598,7,1.5509181969949917,1527,190.875,0
2,2,2361,404,10,5.82962962962963,2765,251.36363636363637,0
1,0,295,322,72,0.913312693498452,617,8.452054794520548,0
0,1,1442,561,57,2.565836298932384,2003,34.53448275862069,0
1,3,1239,27,4,44.25,1266,253.2,0
1,0,174,828,79,0.20989143546441497,1002,12.525,0
1,3,652,745,0,0.8739946380697051,1397,1397.0,0
1,0,656,261,51,2.50381679389313,917,17.634615384615383,0
0,0,363,158,9,2.2830188679245285,521,52.1,0
2,0,1513,60,6,24.80327868852459,1573,224.71428571428572,1
1,3,2602,708,17,3.669957686882934,3310,183.88888888888889,0
0,1,1260,673,68,1.8694362017804154,1933,28.014492753623188,0
2,1,3610,609,46,5.918032786885246,4219,89.76595744680851,0
2,3,51,3393,102,0.015026517383618149,3444,33.43689320388349,0
2,1,37,606,23,0.060955518945634266,643,26.791666666666668,0
1,2,2242,1023,21,2.189453125,3265,148.4090909090909,0
1,1,2280,95,0,23.75,2375,2375.0,1
2,2,113,284,5,0.39649122807017545,397,66.16666666666667,0
2,2,442,257,20,1.7131782945736433,699,33.285714285714285,0
2,2,1804,686,41,2.625909752547307,2490,59.285714285714285,0
2,3,137,321,51,0.4254658385093168,458,8.807692307692308,0
2,1,311,819,9,0.37926829268292683,1130,113.0,0
2,1,1142,937,37,1.2174840085287846,2079,54.71052631578947,0
0,3,4011,27,52,143.25,4038,76.18867924528301,1
2,3,1595,816,14,1.952264381884945,2411,160.73333333333332,0
1,1,1502,99,35,15.02,1601,44.47222222222222,0
1,3,419,500,17,0.8363273453093812,919,51.05555555555556,0
1,3,1082,1037,127,1.0423892100192678,2119,16.5546875,0
2,2,120,972,0,0.12332990750256938,1092,1092.0,0
1,3,4862,285,16,17.0,5147,302.7647058823529,0
0,2,655,254,9,2.5686274509803924,909,90.9,0
2,0,1018,464,56,2.189247311827957,1482,26.0,0
1,2,2088,167,10,12.428571428571429,2255,205.0,0
0,2,0,2941,23,0.0,2941,122.54166666666667,0
0,3,3728,338,40,10.997050147492626,4066,99.17073170731707,1
1,1,444,2051,20,0.21637426900584794,2495,118.80952380952381,0
0,0,414,1911,15,0.21652719665271966,2325,145.3125,0
1,0,156,363,1,0.42857142857142855,519,259.5,0
0,0,1953,234,0,8.310638297872341,2187,2187.0,0
2,1,2046,1178,94,1.7353689567430026,3224,33.93684210526316,0
2,0,20,208,30,0.09569377990430622,228,7.354838709677419,0
2,0,57,589,52,0.09661016949152543,646,12.18867924528302,0
2,1,2505,93,19,26.648936170212767,2598,129.9,0
2,0,131,390,9,0.3350383631713555,521,52.1,0
1,3,970,65,10,14.696969696969697,1035,94.0909090909091,0
2,3,966,266,1,3.6179775280898876,1232,616.0,0
2,2,2038,875,46,2.32648401826484,2913,61.97872340425532,0
2,2,850,3796,26,0.22386094284961813,4646,172.07407407407408,1
2,2,569,235,19,2.4110169491525424,804,40.2,0
0,3,3664,512,57,7.1423001949317735,4176,72.0,0
2,3,259,475,17,0.5441176470588235,734,40.77777777777778,0
2,3,304,162,88,1.8650306748466257,466,5.235955056179775,0
1,2,88,753,0,0.11671087533156499,841,841.0,0
0,2,3701,1031,125,3.5862403100775193,4732,37.55555555555556,1
1,2,1225,127,50,9.5703125,1352,26.50980392156863,1
2,2,12,1132,13,0.01059135039717564,1144,81.71428571428571,0
1,2,1218,963,27,1.2634854771784232,2181,77.89285714285714,0
1,2,517,175,59,2.9375,692,11.533333333333333,0
2,3,3428,837,19,4.090692124105012,4265,213.25,0
0,1,324,400,1,0.8079800498753117,724,362.0,0
0,1,1238,914,70,1.3530054644808742,2152,30.309859154929576,0
1,2,987,548,21,1.7978142076502732,1535,69.77272727272727,0
2,1,12,39,23,0.3,51,2.125,0
1,1,2164,1237,0,1.7479806138933764,3401,3401.0,0
1,3,150,648,3,0.23112480739599384,798,199.5,0
1,2,1089,1032,45,1.054211035818006,2121,46.108695652173914,0
2,2,1494,107,17,13.833333333333334,1601,88.94444444444444,0
2,1,996,1022,187,0.9736070381231672,2018,10.73404255319149,0
0,2,102,427,35,0.2383177570093458,529,14.694444444444445,0
2,2,3696,1284,89,2.8762645914396887,4980,55.333333333333336,1
1,2,270,731,9,0.36885245901639346,1001,100.1,0
1,2,988,350,5,2.814814814814815,1338,223.0,0
0,1,1595,180,14,8.812154696132596,1775,118.33333333333333,1
2,0,2800,1353,9,2.06794682422452,4153,415.3,0
1,1,926,657,28,1.4072948328267476,1583,54.58620689655172,0
0,3,299,3503,40,0.0853310502283105,3802,92.73170731707317,0
0,0,1811,374,15,4.8293333333333335,2185,136.5625,0
1,0,178,925,2,0.19222462203023757,1103,367.6666666666667,0
1,0,22,780,0,0.028169014084507043,802,802.0,0
2,1,2387,811,7,2.939655172413793,3198,399.75,0
0,3,856,1068,39,0.8007483629560337,1924,48.1,0
1,1,72,119,7,0.6,191,23.875,0
0,3,866,638,72,1.3552425665101722,1504,20.602739726027398,0
2,1,156,569,31,0.2736842105263158,725,22.65625,0
1,1,31,335,59,0.09226190476190477,366,6.1,0
2,1,123,458,14,0.2679738562091503,581,38.733333333333334,0
0,0,1492,585,123,2.546075085324232,2077,16.75,0
2,1,1409,309,34,4.54516129032258,1718,49.08571428571429,1
2,3,927,277,13,3.3345323741007196,1204,86.0,0
0,3,234,1072,7,0.21808014911463186,1306,163.25,0
2,3,1343,55,60,23.982142857142858,1398,22.918032786885245,1
0,0,524,300,11,1.7408637873754154,824,68.66666666666667,0
1,1,714,848,1,0.8409893992932862,1562,781.0,0
0,1,2279,187,9,12.122340425531915,2466,246.6,0
0,2,612,679,5,0.9,1291,215.16666666666666,0
1,0,984,287,11,3.4166666666666665,1271,105.91666666666667,1
0,3,3263,1482,28,2.200269723533378,4745,163.6206896551724,0
1,3,600,344,20,1.7391304347826086,944,44.95238095238095,0
1,1,822,208,37,3.9330143540669855,1030,27.105263157894736,0
0,3,878,604,12,1.4512396694214875,1482,114.0,0
2,1,275,116,3,2.3504273504273505,391,97.75,0
2,1,1335,1277,5,1.0446009389671362,2612,435.3333333333333,0
1,2,1296,911,47,1.4210526315789473,2207,45.979166666666664,0
2,0,240,1177,3,0.2037351443123939,1417,354.25,0
2,1,13,407,48,0.031862745098039214,420,8.571428571428571,0
0,1,6850,1441,7,4.750346740638003,8291,1036.375,0
1,1,871,544,34,1.5981651376146788,1415,40.42857142857143,0
1,2,199,79,29,2.4875,278,9.266666666666667,0
0,1,333,202,3,1.6403940886699508,535,133.75,0
2,0,961,993,32,0.9668008048289738,1954,59.21212121212121,0
1,0,148,1813,17,0.08158765159867695,1961,108.94444444444444,0
2,3,37,80,36,0.4567901234567901,117,3.1621621621621623,0
1,0,1601,1597,54,1.0018773466833542,3198,58.14545454545455,0
1,3,1258,1283,1,0.9797507788161994,2541,1270.5,0
1,0,370,352,31,1.048158640226629,722,22.5625,0
1,3,60,935,3,0.0641025641025641,995,248.75,0
2,1,666,165,14,4.0120481927710845,831,55.4,0
2,2,323,1343,0,0.24032738095238096,1666,1666.0,0
2,2,507,856,11,0.5915985997666278,1363,113.58333333333333,0
2,2,320,462,5,0.6911447084233261,782,130.33333333333334,0
0,1,192,1599,24,0.12,1791,71.64,0
1,2,489,119,21,4.075,608,27.636363636363637,0
1,0,3349,1495,47,2.2386363636363638,4844,100.91666666666667,0
1,3,309,19,30,15.45,328,10.580645161290322,0
0,1,409,1119,37,0.3651785714285714,1528,40.21052631578947,0
2,2,399,681,2,0.5850439882697948,1080,360.0,0
1,0,654,954,0,0.6848167539267016,1608,1608.0,0
2,0,1854,425,104,4.352112676056338,2279,21.704761904761906,0
2,1,514,1598,16,0.3214509068167605,2112,124.23529411764706,0
0,1,1640,300,15,5.4485049833887045,1940,121.25,0
0,2,122,257,1,0.4728682170542636,379,189.5,0
2,3,2252,287,3,7.819444444444445,2539,634.75,0
1,2,204,1191,84,0.17114093959731544,1395,16.41176470588235,0
1,2,39,547,35,0.07116788321167883,586,16.27777777777778,0
0,1,172,616,15,0.2787682333873582,788,49.25,0
0,2,211,1425,70,0.1479663394109397,1636,23.04225352112676,0
0,2,710,1433,26,0.49511854951185497,2143,79.37037037037037,0
0,3,597,141,41,4.204225352112676,738,17.571428571428573,0
0,0,1258,638,16,1.9687010954616588,1896,111.52941176470588,0
0,0,52,107,16,0.48148148148148145,159,9.352941176470589,0
0,3,688,1623,2,0.4236453201970443,2311,770.3333333333334,0
1,0,404,1451,39,0.27823691460055094,1855,46.375,0
0,2,996,1514,3,0.6574257425742575,2510,627.5,0
0,3,44,976,43,0.04503582395087001,1020,23.181818181818183,0
1,3,35,503,6,0.06944444444444445,538,76.85714285714286,0
1,1,557,414,8,1.342168674698795,971,107.88888888888889,0
2,0,1667,402,74,4.136476426799008,2069,27.586666666666666,0
0,1,1111,54,19,20.2,1165,58.25,1
0,2,16,2378,4,0.006725514922236234,2394,478.8,0
0,3,196,478,70,0.4091858037578288,674,9.492957746478874,0
0,2,257,2128,18,0.12071395021136684,2385,125.52631578947368,0
2,0,550,1691,4,0.32505910165484636,2241,448.2,0
1,1,883,1411,14,0.6253541076487252,2294,152.93333333333334,0
1,0,243,709,26,0.34225352112676055,952,35.25925925925926,0
0,2,482,85,13,5.604651162790698,567,40.5,0
0,1,876,313,77,2.789808917197452,1189,15.243589743589743,0
0,0,483,740,9,0.6518218623481782,1223,122.3,0
2,2,154,10,5,14.0,164,27.333333333333332,1
2,0,676,34,7,19.314285714285713,710,88.75,0
1,3,391,905,2,0.4315673289183223,1296,432.0,0
0,1,1996,1752,18,1.1386195094124358,3748,197.26315789473685,0
0,1,1494,1545,63,0.9663648124191462,3039,47.484375,0
0,1,211,147,10,1.4256756756756757,358,32.54545454545455,0
0,3,165,1937,8,0.08513931888544891,2102,233.55555555555554,0
2,1,427,953,54,0.44758909853249473,1380,25.09090909090909,0
1,3,531,1007,10,0.5267857142857143,1538,139.8181818181818,0
1,1,2688,289,19,9.26896551724138,2977,148.85,0
2,0,358,1007,0,0.3551587301587302,1365,1365.0,0
0,0,2021,989,10,2.0414141414141413,3010,273.6363636363636,0
1,0,703,722,4,0.9723374827109267,1425,285.0,0
1,0,2168,353,3,6.124293785310734,2521,630.25,0
2,3,1210,1332,16,0.9077269317329333,2542,149.52941176470588,0
0,2,1232,2218,9,0.555205047318612,3450,345.0,0
1,2,731,1631,5,0.4479166666666667,2362,393.6666666666667,0
0,0,1834,222,21,8.22421524663677,2056,93.45454545454545,0
1,2,293,472,45,0.6194503171247357,765,16.630434782608695,0
2,2,2378,335,39,7.0773809523809526,2713,67.825,0
0,1,1012,983,8,1.0284552845528456,1995,221.66666666666666,0
2,3,577,1424,9,0.4049122807017544,2001,200.1,0
1,0,4027,194,39,20.651282051282053,4221,105.525,0
2,2,1980,2354,24,0.8407643312101911,4334,173.36,1
2,2,1478,904,40,1.6331491712707182,2382,58.09756097560975,0
2,0,320,197,0,1.6161616161616161,517,517.0,0
1,1,3639,371,2,9.78225806451613,4010,1336.6666666666667,1
0,0,1358,88,48,15.258426966292134,1446,29.510204081632654,0
2,1,929,727,57,1.276098901098901,1656,28.551724137931036,0
0,2,2548,148,12,17.100671140939596,2696,207.3846153846154,1
1,3,176,944,95,0.18624338624338624,1120,11.666666666666666,0
0,1,149,1069,10,0.13925233644859814,1218,110.72727272727273,0
2,1,829,522,66,1.5850860420650095,1351,20.16417910447761,0
2,0,58,78,16,0.7341772151898734,136,8.0,0
2,2,1090,755,24,1.4417989417989419,1845,73.8,0
2,3,275,372,30,0.7372654155495979,647,20.870967741935484,0
2,0,126,2390,4,0.05269761606022585,2516,503.2,0
2,0,526,575,1,0.9131944444444444,1101,550.5,0
1,3,627,60,16,10.278688524590164,687,40.411764705882355,1
1,2,186,808,5,0.22991347342398022,994,165.66666666666666,0
1,3,42,1208,23,0.034739454094292806,1250,52.083333333333336,0
0,0,534,139,18,3.8142857142857145,673,35.421052631578945,1
0,0,1425,476,3,2.9874213836477987,1901,475.25,0
1,1,2073,1087,32,1.9053308823529411,3160,95.75757575757575,0
0,3,102,16,0,6.0,118,118.0,0
0,3,743,23,4,30.958333333333332,766,153.2,0
2,3,305,903,36,0.33738938053097345,1208,32.648648648648646,0
2,0,469,1033,22,0.45357833655706,1502,65.30434782608695,0
0,2,2709,1495,9,1.8108288770053476,4204,420.4,0
0,0,433,408,5,1.058679706601467,841,140.16666666666666,0
1,1,454,395,30,1.1464646464646464,849,27.387096774193548,0
0,0,234,643,6,0.36335403726708076,877,125.28571428571429,0
2,0,3219,1132,125,2.8411297440423655,4351,34.53174603174603,0
0,0,609,819,61,0.7426829268292683,1428,23.032258064516128,0
1,1,844,317,4,2.6540880503144653,1161,232.2,0
2,3,603,340,58,1.7683284457478006,943,15.983050847457626,0
2,2,291,1151,12,0.2526041666666667,1442,110.92307692307692,0
2,2,1662,611,20,2.715686274509804,2273,108.23809523809524,0
2,1,28,82,4,0.3373493975903614,110,22.0,0
0,3,1171,132,3,8.80451127819549,1303,325.75,0
1,3,902,1524,60,0.5914754098360656,2426,39.77049180327869,0
0,1,155,5382,29,0.028794352591491733,5537,184.56666666666666,0
0,0,181,327,18,0.551829268292683,508,26.736842105263158,0
2,3,1076,391,1,2.7448979591836733,1467,733.5,0
1,2,374,134,76,2.77037037037037,508,6.597402597402597,0
2,1,308,215,14,1.4259259259259258,523,34.86666666666667,0
0,2,60,442,16,0.13544018058690746,502,29.529411764705884,0
0,0,1454,267,10,5.425373134328358,1721,156.45454545454547,0
2,1,2142,966,66,2.215098241985522,3108,46.38805970149254,0
0,2,1713,617,12,2.7718446601941746,2330,179.23076923076923,0
0,2,627,1382,5,0.45336225596529284,2009,334.8333333333333,0
2,0,763,1031,20,0.7393410852713178,1794,85.42857142857143,0
0,1,277,109,45,2.518181818181818,386,8.391304347826088,0
1,3,189,105,13,1.7830188679245282,294,21.0,0
2,3,1731,1807,31,0.9574115044247787,3538,110.5625,0
1,2,1601,1369,10,1.1686131386861314,2970,270.0,0
0,0,1502,504,38,2.9742574257425742,2006,51.43589743589744,0
0,2,622,111,33,5.553571428571429,733,21.558823529411764,0
2,0,1998,1830,34,1.091206990715456,3828,109.37142857142857,0
0,3,2606,209,31,12.40952380952381,2815,87.96875,0
2,2,398,28,5,13.724137931034482,426,71.0,0
2,2,254,2064,65,0.12300242130750605,2318,35.121212121212125,0
2,0,624,1324,26,0.47094339622641507,1948,72.14814814814815,0
2,1,197,945,14,0.20824524312896406,1142,76.13333333333334,0
2,0,2154,27,5,76.92857142857143,2181,363.5,1
1,1,412,601,45,0.6843853820598007,1013,22.02173913043478,0
2,3,858,848,21,1.010600706713781,1706,77.54545454545455,0
1,2,903,1139,4,0.7921052631578948,2042,408.4,0
0,2,723,509,76,1.4176470588235295,1232,16.0,0
2,0,170,2452,3,0.06930289441500204,2622,655.5,0
0,0,4710,224,22,20.933333333333334,4934,214.52173913043478,0
2,3,189,57,28,3.2586206896551726,246,8.482758620689655,0
1,3,1392,323,206,4.296296296296297,1715,8.285024154589372,0
1,1,1567,867,4,1.805299539170507,2434,486.8,0
1,3,156,1068,28,0.14593077642656688,1224,42.206896551724135,0
0,3,2705,1073,19,2.5186219739292364,3778,188.9,0
2,3,668,93,8,7.1063829787234045,761,84.55555555555556,0
0,3,991,1730,85,0.5725014442518775,2721,31.63953488372093,0
1,1,1027,263,46,3.890151515151515,1290,27.4468085106383,1
0,3,703,188,45,3.7195767195767195,891,19.369565217391305,1
1,1,153,762,68,0.20052424639580602,915,13.26086956521739,0
1,0,1393,190,38,7.293193717277487,1583,40.58974358974359,0
1,2,871,567,21,1.533450704225352,1438,65.36363636363636,0
2,0,126,418,14,0.30071599045346065,544,36.266666666666666,0
2,3,1205,211,36,5.683962264150943,1416,38.270270270270274,0
1,2,1213,276,27,4.379061371841155,1489,53.17857142857143,0
0,3,795,446,23,1.778523489932886,1241,51.708333333333336,0
0,3,94,339,26,0.27647058823529413,433,16.037037037037038,0
2,0,434,384,31,1.1272727272727272,818,25.5625,0
1,3,52,1063,103,0.04887218045112782,1115,10.721153846153847,0
0,0,649,147,41,4.385135135135135,796,18.952380952380953,0
1,3,2369,790,5,2.9949431099873576,3159,526.5,0
0,1,2,906,18,0.002205071664829107,908,47.78947368421053,0
2,2,310,1295,34,0.23919753086419754,1605,45.857142857142854,0
1,0,1608,1503,5,1.0691489361702127,3111,518.5,0
1,0,9,138,80,0.06474820143884892,147,1.8148148148148149,0
0,2,10,119,2,0.08333333333333333,129,43.0,0
0,0,943,763,28,1.2342931937172774,1706,58.827586206896555,0
0,2,1556,1131,111,1.3745583038869258,2687,23.991071428571427,0
1,1,1498,254,39,5.874509803921568,1752,43.8,1
2,3,1512,596,33,2.5326633165829144,2108,62.0,0
2,1,447,1183,178,0.37753378378378377,1630,9.106145251396647,0
0,3,2143,1167,47,1.8347602739726028,3310,68.95833333333333,0
2,2,12,848,105,0.014134275618374558,860,8.11320754716981,0
0,1,374,65,36,5.666666666666667,439,11.864864864864865,0
2,3,411,41,32,9.785714285714286,452,13.696969696969697,0
1,2,181,393,43,0.4593908629441624,574,13.045454545454545,0
0,3,409,21,6,18.59090909090909,430,61.42857142857143,1
2,0,881,1875,49,0.46961620469083154,2756,55.12,0
1,0,734,16,105,43.1764705882353,750,7.0754716981132075,0
2,2,384,24,28,15.36,408,14.068965517241379,1
1,3,1383,144,0,9.537931034482758,1527,1527.0,0
1,0,1254,788,2,1.5893536121673004,2042,680.6666666666666,0
2,1,329,623,8,0.5272435897435898,952,105.77777777777777,0
2,3,390,861,20,0.45243619489559167,1251,59.57142857142857,0
1,3,339,1792,16,0.1890686001115449,2131,125.3529411764706,0
1,0,137,485,116,0.28189300411522633,622,5.316239316239316,0
1,0,1397,35,87,38.80555555555556,1432,16.272727272727273,0
0,2,47,1153,14,0.04072790294627383,1200,80.0,0
1,3,163,1336,47,0.1219147344801795,1499,31.229166666666668,0
0,1,111,40,30,2.707317073170732,151,4.870967741935484,0
1,0,1744,222,8,7.820627802690583,1966,218.44444444444446,0
0,3,45,1177,80,0.038200339558573854,1222,15.08641975308642,0
1,0,1092,377,9,2.888888888888889,1469,146.9,0
1,2,45,511,61,0.087890625,556,8.96774193548387,0
1,3,1543,1386,30,1.1124729632299928,2929,94.48387096774194,0
2,3,2438,79,29,30.475,2517,83.9,0
2,2,667,904,54,0.7370165745856354,1571,28.563636363636363,0
1,1,1632,193,20,8.412371134020619,1825,86.9047619047619,0
0,0,1225,51,57,23.557692307692307,1276,22.0,0
0,2,1587,868,23,1.8262370540851554,2455,102.29166666666667,0
1,3,1455,103,125,13.990384615384615,1558,12.365079365079366,1
2,2,229,1099,32,0.2081818181818182,1328,40.24242424242424,0
0,3,692,181,14,3.802197802197802,873,58.2,0
2,2,3229,39,43,80.725,3268,74.27272727272727,0
0,1,420,83,21,5.0,503,22.863636363636363,0
1,3,3522,1472,49,2.391038696537678,4994,99.88,1
2,2,875,370,53,2.358490566037736,1245,23.055555555555557,0
0,1,619,287,28,2.1493055555555554,906,31.24137931034483,0
1,1,1072,540,61,1.9815157116451017,1612,26.0,0
1,0,1691,801,15,2.1084788029925186,2492,155.75,0
1,3,501,30,1,16.161290322580644,531,265.5,0
2,0,33,1827,32,0.018052516411378557,1860,56.36363636363637,0
2,1,1233,2545,43,0.4842890809112333,3778,85.86363636363636,0
1,0,3127,432,2,7.221709006928407,3559,1186.3333333333333,0
2,0,980,425,44,2.300469483568075,1405,31.22222222222222,0
0,2,208,1686,30,0.12329579134558388,1894,61.096774193548384,0
1,0,285,448,3,0.6347438752783965,733,183.25,0
1,1,2405,1551,23,1.5496134020618557,3956,164.83333333333334,0
2,0,13,22,3,0.5652173913043478,35,8.75,0
1,3,795,538,11,1.4749536178107607,1333,111.08333333333333,0
0,2,172,2436,48,0.07057858022158392,2608,53.224489795918366,0
2,1,332,233,3,1.4188034188034189,565,141.25,0
2,0,366,247,18,1.4758064516129032,613,32.26315789473684,0
1,3,247,795,27,0.3103015075376884,1042,37.214285714285715,0
1,1,1571,2085,84,0.7531160115052733,3656,43.01176470588236,0
1,0,403,177,40,2.264044943820225,580,14.146341463414634,0
2,2,423,2037,4,0.20755642787046125,2460,492.0,0
1,0,603,870,104,0.6923076923076923,1473,14.028571428571428,0
0,1,2325,3974,19,0.5849056603773585,6299,314.95,0
1,1,1165,1066,13,1.091846298031865,2231,159.35714285714286,0
1,1,63,881,4,0.07142857142857142,944,188.8,0
2,3,40,1349,81,0.02962962962962963,1389,16.9390243902439,0
1,0,835,154,26,5.387096774193548,989,36.629629629629626,0
2,0,2180,2334,132,0.9336188436830836,4514,33.93984962406015,1
1,0,390,144,5,2.689655172413793,534,89.0,0
0,2,284,20,23,13.523809523809524,304,12.666666666666666,1
0,3,1379,957,3,1.4394572025052192,2336,584.0,0
2,3,921,163,22,5.615853658536586,1084,47.130434782608695,1
2,2,832,1137,66,0.7311072056239016,1969,29.388059701492537,0
1,3,161,1267,3,0.12697160883280756,1428,357.0,0
1,2,193,216,9,0.8894009216589862,409,40.9,0
0,1,330,72,34,4.52054794520548,402,11.485714285714286,1
1,1,231,555,2,0.4154676258992806,786,262.0,0
0,3,3555,1767,18,2.0107466063348416,5322,280.10526315789474,1
2,1,18,1503,12,0.011968085106382979,1521,117.0,0
1,1,983,99,54,9.83,1082,19.672727272727272,0
2,1,728,2676,1,0.2719462084422861,3404,1702.0,0
1,0,390,245,59,1.5853658536585367,635,10.583333333333334,0
0,1,2185,343,36,6.351744186046512,2528,68.32432432432432,0
2,0,1109,129,10,8.53076923076923,1238,112.54545454545455,1
2,2,6409,379,6,16.86578947368421,6788,969.7142857142857,1
1,2,184,807,89,0.22772277227722773,991,11.011111111111111,0
2,2,91,564,24,0.16106194690265488,655,26.2,0
0,2,150,1406,12,0.10660980810234541,1556,119.6923076923077,0
2,2,313,820,1,0.3812423873325213,1133,566.5,0
2,1,539,244,5,2.2,783,130.5,0
1,1,1984,652,27,3.0382848392036754,2636,94.14285714285714,0
2,1,333,53,21,6.166666666666667,386,17.545454545454547,0
1,2,2467,695,42,3.5445402298850577,3162,73.53488372093024,0
1,2,621,394,54,1.5721518987341772,1015,18.454545454545453,0
2,0,1041,82,15,12.542168674698795,1123,70.1875,0
0,3,307,293,3,1.0442176870748299,600,150.0,0
1,1,169,1826,47,0.09250136836343732,1995,41.5625,0
2,3,2036,705,24,2.8838526912181304,2741,109.64,0
1,2,115,1868,117,0.061530230069555915,1983,16.805084745762713,0
0,2,1487,423,47,3.5070754716981134,1910,39.791666666666664,1
0,2,869,3087,11,0.2814119170984456,3956,329.6666666666667,0
1,3,1974,357,16,5.5139664804469275,2331,137.11764705882354,0
0,0,1265,1131,8,1.1174911660777385,2396,266.22222222222223,0
2,2,330,291,21,1.13013698630137,621,28.227272727272727,0
2,0,854,89,37,9.488888888888889,943,24.81578947368421,1
1,0,13,1432,28,0.009071877180739707,1445,49.827586206896555,0
0,1,644,1150,12,0.5595134665508253,1794,138.0,0
2,3,89,1374,51,0.06472727272727273,1463,28.134615384615383,0
2,2,560,284,3,1.9649122807017543,844,211.0,0
2,0,116,973,4,0.11909650924024641,1089,217.8,0
1,3,3111,198,15,15.633165829145728,3309,206.8125,0
1,3,740,9,36,74.0,749,20.243243243243242,0
2,2,2444,1610,35,1.5170701427684667,4054,112.61111111111111,0
2,1,22,593,13,0.037037037037037035,615,43.92857142857143,0
0,1,1015,3290,35,0.30841689456092375,4305,119.58333333333333,1
0,0,366,388,1,0.9408740359897172,754,377.0,0
0,1,565,2514,10,0.22465208747514911,3079,279.90909090909093,0
1,1,2064,763,35,2.701570680628272,2827,78.52777777777777,0
2,1,3913,574,6,6.805217391304348,4487,641.0,1
1,3,283,288,7,0.9792387543252595,571,71.375,0
2,2,2961,1395,2,2.121060171919771,4356,1452.0,1
0,3,1167,1411,13,0.8264872521246459,2578,184.14285714285714,0
0,3,3024,431,52,7.0,3455,65.18867924528301,0
0,2,826,1039,54,0.7942307692307692,1865,33.90909090909091,0
0,3,3237,474,59,6.814736842105263,3711,61.85,1
2,0,2229,1076,1,2.0696378830083564,3305,1652.5,0
0,0,137,4118,151,0.03326050012138869,4255,27.99342105263158,0
2,3,372,243,20,1.5245901639344261,615,29.285714285714285,0
2,1,278,804,61,0.3453416149068323,1082,17.451612903225808,0
1,3,848,382,70,2.2140992167101827,1230,17.323943661971832,0
0,1,1623,635,21,2.55188679245283,2258,102.63636363636364,0
0,3,1424,1658,1,0.8583484026522001,3082,1541.0,0
1,0,1297,341,27,3.7923976608187133,1638,58.5,0
2,1,470,60,12,7.704918032786885,530,40.76923076923077,0
0,0,150,1283,6,0.11682242990654206,1433,204.71428571428572,0
2,3,236,647,6,0.36419753086419754,883,126.14285714285714,0
1,2,1353,477,24,2.8305439330543933,1830,73.2,0
2,1,159,162,3,0.9754601226993865,321,80.25,0
0,1,252,77,51,3.230769230769231,329,6.326923076923077,0
2,3,552,261,7,2.1068702290076335,813,101.625,0
2,3,74,1015,23,0.07283464566929133,1089,45.375,0
0,1,239,424,4,0.5623529411764706,663,132.6,0
0,2,162,675,58,0.23964497041420119,837,14.186440677966102,0
2,3,3022,68,35,43.79710144927536,3090,85.83333333333333,0
2,3,212,105,6,2.0,317,45.285714285714285,0
1,3,1978,9,37,197.8,1987,52.28947368421053,0
0,2,121,894,2,0.13519553072625698,1015,338.3333333333333,0
2,1,2037,245,44,8.28048780487805,2282,50.71111111111111,0
0,0,914,2727,20,0.3350439882697947,3641,173.38095238095238,0
1,3,1895,295,3,6.402027027027027,2190,547.5,0
2,2,2020,361,23,5.580110497237569,2381,99.20833333333333,0
2,1,907,507,6,1.7854330708661417,1414,202.0,0
2,1,2497,307,33,8.107142857142858,2804,82.47058823529412,1
0,2,880,1360,36,0.6465833945628214,2240,60.54054054054054,0
1,3,1246,1671,42,0.7452153110047847,2917,67.83720930232558,0
0,0,537,8,67,59.666666666666664,545,8.014705882352942,0
2,3,2454,850,31,2.883666274970623,3304,103.25,0
1,1,1738,926,20,1.8748651564185546,2664,126.85714285714286,0
2,0,182,2604,57,0.06986564299424185,2786,48.03448275862069,0
2,3,858,370,69,2.31266846361186,1228,17.542857142857144,0
0,0,2271,173,45,13.051724137931034,2444,53.130434782608695,0
2,2,1575,588,85,2.67402376910017,2163,25.151162790697676,0
1,3,3284,474,116,6.913684210526315,3758,32.11965811965812,1
2,1,263,1255,8,0.20939490445859874,1518,168.66666666666666,0
2,1,458,1874,6,0.24426666666666666,2332,333.14285714285717,0
0,0,707,72,17,9.684931506849315,779,43.27777777777778,0
1,2,264,1499,173,0.176,1763,10.132183908045977,0
0,3,500,1917,2,0.26068821689259647,2417,805.6666666666666,0
2,2,771,2063,37,0.373546511627907,2834,74.57894736842105,0
0,2,212,1156,57,0.18323249783923942,1368,23.586206896551722,0
0,0,296,1084,169,0.2728110599078341,1380,8.117647058823529,0
0,0,133,12,29,10.23076923076923,145,4.833333333333333,1
0,3,1249,2022,14,0.6173999011369253,3271,218.06666666666666,0
2,1,448,346,5,1.2910662824207493,794,132.33333333333334,0
2,3,248,33,120,7.294117647058823,281,2.322314049586777,0
1,2,707,426,77,1.6557377049180328,1133,14.525641025641026,0
0,0,70,1055,48,0.06628787878787878,1125,22.959183673469386,0
0,2,2569,466,86,5.501070663811563,3035,34.88505747126437,0
1,0,348,1135,1,0.30633802816901406,1483,741.5,0
0,1,2175,569,29,3.8157894736842106,2744,91.46666666666667,1
1,2,688,284,9,2.414035087719298,972,97.2,0
2,0,1898,181,43,10.428571428571429,2079,47.25,0
1,3,283,437,3,0.6461187214611872,720,180.0,0
0,3,192,29,8,6.4,221,24.555555555555557,1
1,3,1893,439,56,4.302272727272728,2332,40.91228070175438,1
2,2,239,56,41,4.192982456140351,295,7.023809523809524,0
0,0,1371,1676,144,0.817531305903399,3047,21.013793103448275,0
2,0,422,685,30,0.6151603498542274,1107,35.70967741935484,0
2,0,1379,830,10,1.6594464500601684,2209,200.8181818181818,0
1,2,2382,272,23,8.725274725274724,2654,110.58333333333333,0
2,0,3997,204,86,19.497560975609755,4201,48.28735632183908,0
0,1,445,984,31,0.4517766497461929,1429,44.65625,0
2,2,458,890,63,0.5140291806958474,1348,21.0625,0
2,1,3983,104,0,37.93333333333333,4087,4087.0,0
1,1,1977,218,13,9.027397260273972,2195,156.78571428571428,0
2,3,46,2343,82,0.01962457337883959,2389,28.783132530120483,0
1,2,852,290,1,2.9278350515463916,1142,571.0,0
1,0,199,20,21,9.476190476190476,219,9.954545454545455,0
0,1,5118,52,12,96.56603773584905,5170,397.6923076923077,0
0,2,149,1195,31,0.1245819397993311,1344,42.0,0
0,0,819,1132,5,0.7228596646072374,1951,325.1666666666667,0
0,3,1094,384,31,2.8415584415584414,1478,46.1875,0
1,2,2765,133,144,20.634328358208954,2898,19.986206896551725,0
2,2,1879,551,9,3.403985507246377,2430,243.0,0
0,2,282,322,18,0.8730650154798761,604,31.789473684210527,0
0,0,850,374,0,2.2666666666666666,1224,1224.0,0
0,1,3069,241,17,12.681818181818182,3310,183.88888888888889,0
2,1,1330,51,15,25.576923076923077,1381,86.3125,1
0,2,1165,1252,24,0.9297685554668795,2417,96.68,0
2,2,1406,770,8,1.8236057068741893,2176,241.77777777777777,0
1,0,389,1439,11,0.2701388888888889,1828,152.33333333333334,0
1,3,1306,559,28,2.3321428571428573,1865,64.3103448275862,0
1,2,265,3359,71,0.07886904761904762,3624,50.333333333333336,0
2,2,558,2627,8,0.21232876712328766,3185,353.8888888888889,0
0,3,2206,253,33,8.68503937007874,2459,72.32352941176471,1
0,2,19,391,22,0.04846938775510204,410,17.82608695652174,0
0,1,534,1117,3,0.4776386404293381,1651,412.75,0
0,2,310,1199,25,0.25833333333333336,1509,58.03846153846154,0
0,1,221,1932,37,0.11433005690636316,2153,56.6578947368421,0
2,0,1823,845,27,2.1548463356973997,2668,95.28571428571429,0
1,0,1192,515,3,2.310077519379845,1707,426.75,0
0,1,119,379,57,0.3131578947368421,498,8.586206896551724,0
1,1,682,434,1,1.567816091954023,1116,558.0,0
2,3,629,1519,8,0.4138157894736842,2148,238.66666666666666,0
2,1,153,3129,28,0.04888178913738019,3282,113.17241379310344,0
0,1,1608,42,7,37.395348837209305,1650,206.25,1
2,2,456,694,3,0.6561151079136691,1150,287.5,0
1,3,1435,587,21,2.4404761904761907,2022,91.9090909090909,0
0,1,213,377,38,0.5634920634920635,590,15.128205128205128,0
0,1,378,1526,15,0.2475442043222004,1904,119.0,0
1,1,100,685,35,0.1457725947521866,785,21.805555555555557,0
0,2,154,300,59,0.5116279069767442,454,7.566666666666666,0
0,2,2147,469,95,4.568085106382979,2616,27.25,0
1,2,115,353,7,0.3248587570621469,468,58.5,0
0,0,100,449,27,0.2222222222222222,549,19.607142857142858,0
0,2,2819,59,9,46.983333333333334,2878,287.8,0
1,1,1038,94,61,10.926315789473684,1132,18.258064516129032,0
2,2,106,781,66,0.13554987212276215,887,13.238805970149254,0
1,2,3565,921,11,3.866594360086768,4486,373.8333333333333,1
0,3,159,809,31,0.1962962962962963,968,30.25,0
1,1,1453,1152,65,1.2601908065915004,2605,39.46969696969697,0
0,2,35,2299,21,0.015217391304347827,2334,106.0909090909091,0
0,0,979,1576,38,0.6207989854153456,2555,65.51282051282051,0
1,3,791,433,48,1.8225806451612903,1224,24.979591836734695,0
0,2,233,196,61,1.1827411167512691,429,6.919354838709677,0
2,3,1030,299,21,3.433333333333333,1329,60.40909090909091,0
0,3,959,708,85,1.3526093088857545,1667,19.38372093023256,0
1,0,1601,1551,29,1.0315721649484537,3152,105.06666666666666,0
2,0,2086,967,4,2.1549586776859506,3053,610.6,0
2,0,713,626,28,1.1371610845295055,1339,46.172413793103445,0
0,1,673,736,10,0.9131614654002713,1409,128.0909090909091,0
1,3,971,601,13,1.6129568106312293,1572,112.28571428571429,0
0,2,1306,2849,49,0.45824561403508773,4155,83.1,0
0,0,440,1354,108,0.3247232472324723,1794,16.458715596330276,0
1,0,702,1215,61,0.5773026315789473,1917,30.919354838709676,0
1,3,879,582,11,1.5077186963979416,1461,121.75,0
0,3,4454,322,18,13.789473684210526,4776,251.3684210526316,0
2,3,886,15,123,55.375,901,7.266129032258065,0
0,2,253,35,77,7.027777777777778,288,3.6923076923076925,1
2,1,886,24,113,35.44,910,7.982456140350878,0
0,1,1712,3148,17,0.5436646554461734,4860,270.0,1
1,0,1947,97,48,19.867346938775512,2044,41.714285714285715,1
2,1,1610,122,61,13.089430894308943,1732,27.93548387096774,0
1,2,2191,529,1,4.133962264150943,2720,1360.0,0
1,1,407,525,9,0.7737642585551331,932,93.2,0
1,2,708,2020,64,0.3503216229589312,2728,41.96923076923077,0
1,0,1512,61,14,24.387096774193548,1573,104.86666666666666,0
1,3,307,2521,9,0.12172878667724028,2828,282.8,0
0,2,464,195,9,2.36734693877551,659,65.9,0
2,3,1778,2809,14,0.6327402135231317,4587,305.8,1
0,0,1470,623,8,2.355769230769231,2093,232.55555555555554,0
0,2,3547,844,0,4.197633136094675,4391,4391.0,1
0,2,5514,303,5,18.138157894736842,5817,969.5,0
1,1,275,757,64,0.3627968337730871,1032,15.876923076923077,0
0,2,2307,992,2,2.323262839879154,3299,1099.6666666666667,0
2,0,99,8,15,11.0,107,6.6875,0
0,3,1237,27,18,44.17857142857143,1264,66.52631578947368,0
1,2,248,3442,45,0.07203020621550973,3690,80.21739130434783,0
2,0,357,489,8,0.7285714285714285,846,94.0,0
2,0,2924,2196,11,1.3309057806099227,5120,426.6666666666667,1
2,2,305,1047,0,0.29103053435114506,1352,1352.0,0
2,1,1118,373,69,2.9893048128342246,1491,21.3,0
0,2,196,130,34,1.4961832061068703,326,9.314285714285715,0
1,2,98,3058,9,0.032036613272311214,3156,315.6,0
2,1,414,702,65,0.5889046941678521,1116,16.90909090909091,0
2,0,978,170,2,5.719298245614035,1148,382.6666666666667,0
1,2,284,915,13,0.31004366812227074,1199,85.64285714285714,0
0,1,356,77,24,4.564102564102564,433,17.32,1
2,3,1233,1620,21,0.7606415792720543,2853,129.6818181818182,0
0,3,108,75,31,1.4210526315789473,183,5.71875,0
0,1,592,215,10,2.740740740740741,807,73.36363636363636,0
0,0,2842,76,42,36.90909090909091,2918,67.86046511627907,1
0,1,505,87,15,5.738636363636363,592,37.0,0
2,0,569,593,4,0.9579124579124579,1162,232.4,0
2,3,1340,929,40,1.4408602150537635,2269,55.34146341463415,0
0,2,1509,1242,72,1.2139983909895415,2751,37.68493150684932,0
0,1,1467,950,13,1.5425867507886435,2417,172.64285714285714,0
1,3,6150,361,26,16.988950276243095,6511,241.14814814814815,0
1,2,74,651,34,0.11349693251533742,725,20.714285714285715,0
1,3,4031,2101,53,1.917697431018078,6132,113.55555555555556,1
2,1,2999,392,6,7.631043256997455,3391,484.42857142857144,0
1,1,1911,232,25,8.201716738197424,2143,82.42307692307692,0
2,2,605,586,40,1.030664395229983,1191,29.048780487804876,0
2,1,2047,282,6,7.23321554770318,2329,332.7142857142857,0
2,3,249,242,19,1.0246913580246915,491,24.55,0
2,2,1568,1206,18,1.2990886495443248,2774,146.0,0
1,2,204,1771,54,0.11512415349887133,1975,35.90909090909091,0
0,3,1689,558,45,3.0214669051878356,2247,48.84782608695652,0
0,0,953,1210,7,0.786952931461602,2163,270.375,0
0,2,103,165,7,0.6204819277108434,268,33.5,0
1,0,2256,634,38,3.552755905511811,2890,74.1025641025641,0
0,3,862,808,40,1.065512978986403,1670,40.73170731707317,0
1,3,1067,539,5,1.9759259259259259,1606,267.6666666666667,0
1,2,333,99,15,3.33,432,27.0,0
1,1,2052,1059,52,1.9358490566037736,3111,58.698113207547166,0
0,2,787,1461,2,0.5383036935704515,2248,749.3333333333334,0
0,1,546,806,14,0.6765799256505576,1352,90.13333333333334,0
0,0,764,148,31,5.12751677852349,912,28.5,0
2,1,1215,61,44,19.596774193548388,1276,28.355555555555554,0
1,2,1187,287,31,4.121527777777778,1474,46.0625,0
2,1,442,30,15,14.258064516129032,472,29.5,1
1,3,486,1462,144,0.3321941216678059,1948,13.434482758620689,0
0,0,826,971,1,0.8497942386831275,1797,898.5,0
1,3,2582,663,20,3.88855421686747,3245,154.52380952380952,0
1,3,1368,1763,21,0.7755102040816326,3131,142.3181818181818,0
2,3,494,93,8,5.25531914893617,587,65.22222222222223,0
1,3,411,1002,24,0.4097706879361914,1413,56.52,0
0,1,741,126,7,5.834645669291339,867,108.375,0
1,3,2040,50,17,40.0,2090,116.11111111111111,0
1,1,8,114,16,0.06956521739130435,122,7.176470588235294,0
1,3,1239,2411,44,0.513681592039801,3650,81.11111111111111,0
2,2,348,464,85,0.7483870967741936,812,9.44186046511628,0
1,3,233,40,6,5.682926829268292,273,39.0,0
1,2,12,700,143,0.017118402282453638,712,4.944444444444445,0
2,1,2269,178,84,12.675977653631286,2447,28.788235294117648,1
2,0,2433,5,3,405.5,2438,609.5,0
2,1,63,1136,73,0.055408970976253295,1199,16.2027027027027,0
2,0,737,134,24,5.45925925925926,871,34.84,0
0,0,165,2284,63,0.07221006564551423,2449,38.265625,0
0,3,1421,718,87,1.976356050069541,2139,24.306818181818183,0
1,0,1094,72,58,14.986301369863014,1166,19.76271186440678,0
0,1,352,196,15,1.7868020304568528,548,34.25,0
1,3,124,755,30,0.164021164021164,879,28.35483870967742,0
0,0,1779,330,18,5.374622356495468,2109,111.0,1
2,1,1121,607,13,1.84375,1728,123.42857142857143,0
2,0,6,1285,8,0.004665629860031105,1291,143.44444444444446,0
0,0,988,1258,17,0.7847498014297061,2246,124.77777777777777,0
0,3,1662,957,49,1.7348643006263047,2619,52.38,0
1,3,893,1737,55,0.5138089758342923,2630,46.964285714285715,0
1,1,552,177,95,3.101123595505618,729,7.59375,0
1,3,876,156,10,5.579617834394904,1032,93.81818181818181,0
2,3,966,1284,31,0.7517509727626459,2250,70.3125,0
2,2,1021,309,35,3.293548387096774,1330,36.94444444444444,0
2,2,3412,574,6,5.9339130434782605,3986,569.4285714285714,0
2,1,196,1089,13,0.1798165137614679,1285,91.78571428571429,0
1,3,975,403,12,2.4133663366336635,1378,106.0,0
2,1,208,111,127,1.8571428571428572,319,2.4921875,0
2,2,235,910,95,0.2579582875960483,1145,11.927083333333334,0
2,2,1106,1359,51,0.8132352941176471,2465,47.40384615384615,0
2,2,2476,10,19,225.0909090909091,2486,124.3,0
0,1,173,661,9,0.26132930513595165,834,83.4,0
1,3,3282,507,74,6.460629921259843,3789,50.52,0
1,0,384,240,9,1.5933609958506223,624,62.4,0
2,3,496,140,22,3.517730496453901,636,27.652173913043477,0
0,1,166,166,8,0.9940119760479041,332,36.888888888888886,0
1,2,956,1032,106,0.925459825750242,1988,18.57943925233645,0
1,0,907,614,1,1.4747967479674797,1521,760.5,0
2,1,583,3177,5,0.18344870988042794,3760,626.6666666666666,0
